,Ticker,Training Data Size,Test Data Size,Accuracy,train_true,train_false,coef,intercept
0,AALI.JK,968,241,0.6224066390041494,426,542,[ 0.01029098 -0.03863844  0.01269489  0.10241201 -0.00257948 -0.32119777],-0.23972014610239714
1,ABBA.JK,880,219,0.6712328767123288,258,622,[ 0.37905682  0.04508792  0.07553254 -0.07047657  0.03379625 -0.12144326],-0.895053371131325
2,ABDA.JK,744,185,0.9135135135135135,75,669,[ 0.00081205  0.17435809 -0.06361443  0.00759394 -0.01989009  0.00341355],-2.2235029237379966
3,ABMM.JK,967,241,0.5643153526970954,261,706,[-0.00121091  0.00015977  0.02697584  0.0293102   0.00084226 -0.05356696],-0.973335210042261
4,ACES.JK,967,241,0.6099585062240664,426,541,[-0.22104993  0.00662511  0.01518923  0.02844341  0.04146572  0.84354817],-0.2477351830660969
5,ACST.JK,967,241,0.5850622406639004,337,630,[ 0.37015398  0.01798546  0.00672396 -0.0605702  -0.00763661 -0.1398016 ],-0.6238486337457237
6,ADCP.JK,211,52,0.8076923076923077,60,151,[-0.04224611  0.16397105 -0.16022276 -0.02231675 -0.06799113 -1.05558345],-0.9096129313834719
7,ADES.JK,966,241,0.5601659751037344,385,581,[ 0.0030783   0.04111108 -0.01106832 -0.05711732  0.00142962 -0.60769432],-0.41372596726626043
8,ADHI.JK,967,241,0.6514522821576764,378,589,[ 0.19814133 -0.01024183  0.02404306 -0.05935316  0.03883738  0.75636159],-0.4554204740722926
9,ADMF.JK,967,241,0.5933609958506224,387,580,[-0.00296874 -0.00443554 -0.01823148  0.01358249  0.01247776 -0.08732288],-0.4075293945312532
10,ADMG.JK,968,241,0.7136929460580913,355,613,[-0.00728597 -0.01012316  0.01578189  0.01205966 -0.0253643  -0.40035959],-0.5457419017732222
11,ADMR.JK,240,59,0.7457627118644068,105,135,[ 0.01603618  0.01674872  0.0154903   0.05105219 -0.00485363  0.01490522],-0.23527415945756544
12,ADRO.JK,967,241,0.5062240663900415,412,555,[-0.1206196  -0.02691183  0.0124104   0.08222375 -0.0609884  -0.15697142],-0.2987296820447888
13,AGAR.JK,646,161,0.6211180124223602,183,463,[-0.27411771 -0.01999058  0.01589574  0.06318769  0.02018366 -2.07335799],-0.9167074478674705
14,AGII.JK,967,241,0.5643153526970954,375,592,[ 0.17702432  0.00336206 -0.00389232 -0.00404194 -0.03773058 -0.64414652],-0.4489917719231219
15,AGRO.JK,967,241,0.6265560165975104,367,600,"[-1.40247606e-07 -4.02029017e-05  1.08351682e-04 -1.45541517e-05
  2.58754025e-05  2.24502896e-06]",-0.00024690100865993697
16,AGRS.JK,967,241,0.6846473029045643,330,637,[-0.14058265 -0.05765449  0.12678043  0.02892698 -0.00507904 -1.14312876],-0.6560606772893952
17,AHAP.JK,966,241,0.6887966804979253,284,682,"[-1.06000897e-01 -1.14692029e-02 -1.30111163e-02  3.98736012e-02
  7.74856579e-04 -1.76054382e+00]",-0.8774745598922891
18,AIMS.JK,623,155,0.6451612903225806,194,429,[0. 0. 0. 0. 0. 0.],0.0
19,AISA.JK,548,136,0.6102941176470589,189,359,[ 0.21447522  0.00720201  0.07002858  0.00814217 -0.02515588 -0.79012622],-0.6435740838714987
20,AKKU.JK,61,15,1.0,4,57,[-0.00616645  0.00117497  0.06636364  0.03530282  0.1146544  -0.158653  ],-2.6245337475686132
21,AKPI.JK,964,240,0.65,256,708,[-0.19673667 -0.00230848  0.02295249 -0.00844322  0.00593612 -0.38438942],-1.015801288641006
22,AKRA.JK,968,241,0.5518672199170125,408,560,[ 0.00287644 -0.0107638  -0.05642173  0.04534769 -0.03261121  0.34100746],-0.329315767126704
23,AKSI.JK,967,241,0.7012448132780082,319,648,[ 0.01283254 -0.02315085 -0.00741498 -0.2044262   0.0113174   0.43592102],-0.7192922748207903
24,ALDO.JK,933,233,0.6523605150214592,281,652,"[ 2.24692696e-03 -1.42434914e-05 -2.34288856e-02  1.68744309e-02
 -1.19726091e-02 -7.00768248e-01]",-0.8584105221401682
25,ALKA.JK,967,241,0.6514522821576764,298,669,"[-4.81158232e-01 -4.96164293e-03 -8.98722211e-04 -2.97673710e-03
 -7.93106812e-03 -9.66108247e-01]",-0.808221846271844
26,ALMI.JK,967,241,0.6016597510373444,325,642,[-0.29685624 -0.03581338 -0.00275272  0.12440271  0.0145255  -2.03321199],-0.6927727663293134
27,ALTO.JK,908,226,0.7920353982300885,180,728,"[-2.59204125e-01 -3.04493731e-02  1.94894610e-03  2.11365362e-02
  3.19377395e-04 -1.80990585e+00]",-1.4042733312831037
28,AMAG.JK,963,240,0.6291666666666667,256,707,[-0.19028768  0.02836835 -0.00767128  0.02013962 -0.00506649 -0.43849407],-1.0180485743873786
29,AMAN.JK,590,147,0.782312925170068,167,423,[ 0.2587198   0.00497693  0.00635296 -0.04813043 -0.00217841  0.26606503],-0.9342115682673262
30,AMAR.JK,627,156,0.5576923076923077,229,398,[-0.19893314  0.07330598 -0.02336547  0.13233228 -0.00658848 -0.32742585],-0.5532570999123855
31,AMFG.JK,960,240,0.5875,256,704,[ 0.14866109 -0.02984866  0.01163831 -0.00418187  0.00664557 -0.17728728],-1.0118861783238788
32,AMIN.JK,964,241,0.6639004149377593,265,699,[-0.37445556 -0.02589499 -0.01073865 -0.05173901 -0.00627356 -0.91449646],-0.975027965615351
33,AMMS.JK,128,31,0.6774193548387096,31,97,[-0.04030074 -0.21920763 -0.04373309 -0.70217374  0.12926328  0.98324884],-1.2684468784923275
34,AMOR.JK,445,111,0.6396396396396397,171,274,[-0.0504863   0.01820988  0.00514341 -0.01441177  0.05144483  0.03311165],-0.4755989591284745
35,AMRT.JK,967,241,0.5020746887966805,346,621,[-0.01044774 -0.07547269  0.0017767   0.03573322  0.00503369 -1.23997587],-0.5798237526076712
36,ANDI.JK,373,93,0.8924731182795699,96,277,[ 0.08705215 -0.00517359  0.13476461  0.01222769  0.08699676  0.09660447],-1.0532393328586418
37,ANJT.JK,967,241,0.6390041493775933,276,691,"[-1.24977190e-05  3.01705698e-02  5.76907932e-05  2.52785065e-02
  2.14062658e-02  1.02318592e-01]",-0.9216616399040887
38,ANTM.JK,967,241,0.5933609958506224,407,560,[-0.00300342  0.09598289  0.2443057  -0.01420838  0.05795876 -0.09815923],-0.31239435233990454
39,APEX.JK,907,226,0.6858407079646017,268,639,[-0.40916302 -0.01174274 -0.00267689  0.09772447  0.00213139 -0.32350774],-0.876725999663265
40,APIC.JK,923,230,0.5956521739130435,338,585,[-0.00223408  0.03252141 -0.01151343  0.00910358 -0.06205378 -0.21419076],-0.5536142130243357
41,APII.JK,967,241,0.6431535269709544,302,665,"[-3.53495694e-01  7.02591552e-03 -1.16801721e-02 -6.18071038e-02
 -6.20778536e-04 -1.93173780e+00]",-0.7904095364675069
42,APLI.JK,967,241,0.6514522821576764,314,653,"[-4.84757191e-02 -9.07728216e-02 -1.45143746e-02  4.06946583e-02
 -3.61881881e-04 -2.55097610e+00]",-0.7313262652322452
43,APLN.JK,967,241,0.5892116182572614,341,626,[ 0.00468544 -0.05081779 -0.01403992  0.02001118 -0.01641849  0.16043574],-0.6113986579968488
44,ARCI.JK,344,85,0.5882352941176471,124,220,[ 0.00587955 -0.02404748  0.16375108  0.02996055 -0.00673475  0.51616395],-0.5665242848726593
45,ARGO.JK,560,139,0.7194244604316546,172,388,[-0.41398863  0.03205705 -0.01052617  0.21207466 -0.01329102 -1.36294986],-0.8222967574591663
46,ARII.JK,955,238,0.6890756302521008,213,742,[-0.19414849  0.00068646 -0.01964733  0.13722719 -0.00910189  0.22261166],-1.2667170362206286
47,ARKA.JK,444,110,0.8545454545454545,84,360,[ 0.33987941 -0.04540135  0.32402228 -0.38382166 -0.04512616 -0.69067192],-1.5024612502180754
48,ARKO.JK,143,35,0.4857142857142857,52,91,[-0.00287465 -0.20173491  0.23855692  0.0940727   0.35551919  0.01986305],-0.62767558079029
49,ARMY.JK,310,77,0.8051948051948052,94,216,[-0.04540153  0.03528246  0.06810357 -0.36261846  0.01961636 -0.16886728],-0.8413978289040795
50,ARNA.JK,967,241,0.6431535269709544,345,622,[-0.05012567 -0.03309657  0.00758117  0.06718316 -0.00352628 -0.04387134],-0.5861788133815201
51,ARTA.JK,966,241,0.6514522821576764,274,692,[ 0.14756658  0.04259873 -0.00151797 -0.01314796 -0.0184196  -1.17730502],-0.934301675436
52,ARTO.JK,967,241,0.6390041493775933,383,584,[-0.02286913  0.007347   -0.00199983 -0.00677588 -0.00763158 -0.36747945],-0.4276895539722915
53,ASBI.JK,967,241,0.5269709543568465,220,747,[-0.22169734 -0.01835948 -0.04327947  0.08344302  0.00362776 -0.68536155],-1.2209590512101272
54,ASDM.JK,967,241,0.6639004149377593,203,764,[-0.09194917 -0.04976411 -0.06165914 -0.0648234  -0.00251686 -1.73845764],-1.3406651168765413
55,ASGR.JK,967,241,0.6514522821576764,344,623,"[-3.25751410e-03 -4.52415931e-03 -3.93552734e-03  4.46264730e-02
 -3.54792066e-04 -1.15153217e+00]",-0.585315886903552
56,ASHA.JK,166,41,0.6341463414634146,57,109,[ 0.03979766 -0.07437649  0.08445815  0.18480142  0.09577578  0.65650767],-0.6341364438819314
57,ASII.JK,967,241,0.5892116182572614,411,556,[-0.01339418  0.00636047 -0.02087684  0.0164244   0.00633727 -1.04632415],-0.2970630587102941
58,ASJT.JK,967,241,0.6639004149377593,329,638,"[-8.06103919e-02  8.90619551e-02 -2.01026661e-03  1.01483107e-01
 -6.32439604e-04 -2.06837698e+00]",-0.6618632396513042
59,ASLC.JK,227,56,0.5357142857142857,78,149,[-0.05228137  0.04806888 -0.00931483  0.09875234 -0.01503524  0.15357534],-0.6528131829026762
60,ASMI.JK,967,241,0.6721991701244814,287,680,[ 0.21439749  0.025264   -0.06697466  0.03474323 -0.04831843  0.92427617],-0.8808145917656797
61,ASPI.JK,591,147,0.6326530612244898,181,410,[-0.01345391 -0.01514535 -0.02264478 -0.50757541  0.00121418 -0.28908164],-0.8304635964224222
62,ASRI.JK,966,241,0.5892116182572614,367,599,[-0.02652892 -0.00110538 -0.06122218  0.06077143 -0.00715516 -0.66160117],-0.4873694934641715
63,ASRM.JK,936,233,0.7339055793991416,178,758,"[-2.56419612e-01  5.21170085e-02 -2.67825246e-03  3.56986513e-02
  7.25441968e-03 -3.20500656e+00]",-1.5011314123053419
64,ASSA.JK,967,241,0.5809128630705395,376,591,"[ 7.93736495e-02  3.93064629e-02 -1.24145406e-04 -1.85313271e-02
 -1.40722494e-02 -1.03481055e+00]",-0.44772537115907074
65,ATAP.JK,447,111,0.7657657657657657,139,308,[-0.05007253 -0.01564609  0.33361142  0.08158884  0.06914413 -1.31351479],-0.8035055283394382
66,ATIC.JK,968,241,0.6141078838174274,262,706,[-0.3631175   0.00275971  0.00244198 -0.03738996 -0.01360527 -1.08285156],-0.9901291303426694
67,AUTO.JK,967,241,0.5726141078838174,397,570,[-0.00883384 -0.00521656  0.00434811 -0.03077156 -0.00342137  0.23480924],-0.3645210329190746
68,AVIA.JK,253,63,0.5873015873015873,98,155,[-0.02730558  0.11235238 -0.01915046  0.13341423  0.0098207  -0.31827064],-0.4930686600185299
69,AXIO.JK,136,33,0.696969696969697,44,92,[-0.01802011  0.15431185 -0.14723924  0.45101221  0.04438879  0.18624528],-0.7235002315277831
70,AYLS.JK,488,122,0.6885245901639344,147,341,[-0.05345568 -0.10553951  0.0670039   0.10433728 -0.00381558  0.62548416],-0.842421572764888
71,BABP.JK,650,162,0.6604938271604939,154,496,[ 0.33344841 -0.04861309  0.09161933  0.03372167  0.00638522 -0.15637998],-1.1813718846833006
72,BACA.JK,966,241,0.7095435684647303,244,722,"[-2.01288540e-01  2.50867205e-03  3.26406410e-02 -1.52377796e-04
 -2.46147415e-03  9.02260951e-02]",-1.0872658185987292
73,BAJA.JK,967,241,0.6721991701244814,312,655,[-0.00160032 -0.01982863  0.02438094  0.01095952 -0.01686075  0.12838669],-0.7529103369972199
74,BALI.JK,967,241,0.5975103734439834,336,631,"[-6.17713825e-02 -2.35118767e-02  7.86278585e-02 -2.72693719e-03
  2.67871072e-04 -2.73101943e-01]",-0.6342800449558305
75,BANK.JK,421,105,0.5523809523809524,178,243,[-0.18855383 -0.17232846 -0.07129559  0.03469961 -0.03704553 -0.01986378],-0.31683704506945576
76,BAPA.JK,764,191,0.6910994764397905,214,550,[-0.11288036 -0.00480491  0.00201355 -0.05007867  0.0032683  -1.50395085],-0.9465271457683145
77,BATA.JK,965,241,0.6846473029045643,266,699,[-0.03617627  0.01002422 -0.0045649  -0.09466844  0.01037972 -2.8319195 ],-0.9811934309513287
78,BAUT.JK,108,26,1.0,16,92,[-0.02420333  0.74525389  0.32211119 -0.06667013 -0.45618132 -0.30759608],-1.8785852071974567
79,BAYU.JK,967,241,0.7676348547717843,243,724,[-0.30671358  0.01298398 -0.0124903   0.11982516  0.00057065 -0.33018792],-1.095258656710357
80,BBCA.JK,968,241,0.5311203319502075,437,531,[-0.09877025  0.02775781 -0.01395616  0.00336534  0.00401345 -1.45873947],-0.19077474846175105
81,BBHI.JK,966,241,0.6680497925311203,355,611,[-0.09590363 -0.01072586  0.00396369 -0.03687668  0.00111276 -0.44985668],-0.5379297552931273
82,BBKP.JK,967,241,0.7053941908713693,323,644,[ 0.03533019  0.03138158  0.0512416   0.02318243 -0.02995549 -0.48812904],-0.6997712725642198
83,BBLD.JK,967,241,0.6099585062240664,179,788,"[-2.02057069e-02  1.96912800e-02  3.74939008e-02  9.64555447e-03
 -4.72787201e-04 -1.56120876e+00]",-1.4869025691148081
84,BBMD.JK,888,221,0.8099547511312217,173,715,"[ 3.29965317e-03 -4.64541633e-05  3.54695443e-02 -9.91069930e-02
  4.81984980e-03  1.48354239e-01]",-1.4331290581564273
85,BBNI.JK,967,241,0.5892116182572614,426,541,[ 0.00526013  0.12064764  0.03581227  0.09633809 -0.00495899  0.28710301],-0.2465072424681816
86,BBRI.JK,967,241,0.5020746887966805,436,531,"[-3.42064686e-04  2.21449132e-05  2.92779873e-04  3.93102865e-03
  5.83418257e-03 -9.04805409e-03]",-0.19588033639538263
87,BBRM.JK,328,82,0.6951219512195121,66,262,[-0.26569351  0.00299518  0.07034672 -0.00907141 -0.02159245 -0.35247142],-1.3907380643387168
88,BBSI.JK,499,124,0.5483870967741935,209,290,[ 0.01012324  0.01475774 -0.23020491  0.02300425 -0.00213788 -0.54208535],-0.3304803174454378
89,BBSS.JK,556,139,0.6618705035971223,153,403,[-0.05904965  0.03969338  0.07193594  0.10925224  0.00674646 -1.40870234],-0.9799272958831378
90,BBTN.JK,967,241,0.6058091286307054,398,569,[ 0.00627604 -0.010317   -0.01081564  0.00500076  0.00472635 -0.11969136],-0.35847538828445125
91,BBYB.JK,967,241,0.6265560165975104,330,637,"[ 1.85811198e-02 -3.79755104e-02  9.36986217e-05  3.47269313e-03
 -1.67209366e-02 -7.83880502e-01]",-0.6605972552168454
92,BCAP.JK,932,233,0.703862660944206,271,661,[ 0.39387921  0.01341308 -0.1141489   0.17839454 -0.05225467  0.38140131],-0.9008574482447572
93,BCIC.JK,376,94,0.648936170212766,103,273,[ 0.5961687   0.23103277 -0.13396156 -0.15789038 -0.02382349  1.01011543],-0.9793099474380422
94,BCIP.JK,888,221,0.6561085972850679,222,666,[-0.10310604 -0.04479631  0.12619808 -0.0492079   0.00916268 -0.45442243],-1.1074305424283286
95,BDKR.JK,8,2,0.5,5,3,"[-2.28909861e-05  2.39799600e-01  3.93212784e-02 -4.19086172e-03
 -1.95762212e-01  8.77335082e-02]",0.3815883318055502
96,BDMN.JK,967,241,0.6265560165975104,380,587,[ 0.28883118 -0.0191757   0.00260415  0.00550461 -0.00941504  0.33836964],-0.43523065413599454
97,BEBS.JK,365,91,0.7692307692307693,168,197,[0.29803364 0.07033042 0.0292082  0.00906488 0.01377925 0.85965017],-0.1557820157604978
98,BEEF.JK,831,207,0.6811594202898551,261,570,"[-4.18509283e-02 -2.53044103e-04  1.28168790e-01 -8.50570185e-03
 -6.62307480e-03 -8.79267410e-01]",-0.7831320025443518
99,BEER.JK,40,9,0.7777777777777778,15,25,[-0.00687143 -0.06727044 -0.72475262 -0.98641189  0.29399963 -0.05720454],-0.6068860378307811
100,BEKS.JK,256,64,0.96875,69,187,[-0.09795997  0.01563739  0.0390766   0.0287655   0.00601508 -0.54225737],-1.003479688062679
101,BELI.JK,74,18,0.7222222222222222,21,53,[-0.00111038  0.49273887 -0.15325307 -0.0499861   0.23598884 -0.54661389],-1.0532668822307503
102,BELL.JK,968,241,0.6431535269709544,290,678,"[ 4.40491101e-01 -2.12682005e-04  1.85625632e-02  4.35550285e-02
 -3.75035011e-04 -1.49708316e+00]",-0.8581389661457803
103,BESS.JK,593,148,0.5878378378378378,249,344,[ 0.29761287  0.0275828  -0.02068076  0.04119206 -0.0174377   1.53594572],-0.3357085504974596
104,BEST.JK,967,241,0.6182572614107884,336,631,[ 0.07402688 -0.02395589  0.08464658  0.04619429 -0.01570032 -0.07566247],-0.632099485991616
105,BFIN.JK,967,241,0.5435684647302904,349,618,"[ 3.40423610e-04  2.79089879e-02 -1.08894381e-02 -7.15323405e-03
  8.33787751e-02 -7.09387917e-01]",-0.5754735461880214
106,BGTG.JK,934,233,0.6952789699570815,273,661,[ 0.03231217 -0.01709259 -0.02713169 -0.0358999  -0.00801546 -0.91275097],-0.8810422285911972
107,BHAT.JK,570,142,0.6056338028169014,243,327,[ 0.0084643   0.04372899  0.01027485  0.10194524 -0.00154809 -0.75842995],-0.28890358236168473
108,BHIT.JK,889,222,0.7387387387387387,250,639,[-0.02919405  0.00634738 -0.00666707  0.12605715  0.01389836 -0.87904927],-0.9420203840752618
109,BIKA.JK,966,241,0.6597510373443983,309,657,[-0.58491833  0.00910875  0.01611594 -0.00686473  0.0020584  -1.55350394],-0.7457002269979133
110,BIKE.JK,198,49,0.7346938775510204,74,124,[ 0.03648831 -0.22423156  0.01332694 -0.01059038 -0.10131624 -0.01739984],-0.5029808477298952
111,BIMA.JK,700,175,0.6685714285714286,181,519,[-0.15329089 -0.06433131  0.02075126  0.01281856  0.00264929 -1.03977061],-1.0517057508149006
112,BINA.JK,967,241,0.6639004149377593,388,579,"[-1.30430019e-03 -5.38832793e-02  1.88269683e-05 -5.35258694e-02
  1.29636415e-02 -1.72404717e-03]",-0.4031595386574463
113,BINO.JK,260,64,0.765625,95,165,[ 0.00074971  0.08480738  0.06801798 -0.21157552 -0.02249962 -0.57169871],-0.5585591117821612
114,BIPI.JK,508,127,0.5905511811023622,107,401,"[ 2.14631291e-01 -2.15961407e-02  2.53279581e-02 -4.00239686e-04
  3.99637722e-03 -1.10898718e+00]",-1.3294737778500432
115,BIPP.JK,860,215,0.786046511627907,203,657,[-0.14641269  0.01296081 -0.03321654 -0.01533473 -0.00594693 -2.18057791],-1.1840628307810135
116,BIRD.JK,967,241,0.5684647302904564,356,611,"[ 5.75208536e-02  2.30788982e-03 -1.49816968e-02  5.77128522e-04
  1.97604685e-02  7.51334065e-01]",-0.5430124933508526
117,BISI.JK,967,241,0.6224066390041494,339,628,[ 0.11029656  0.00175702 -0.01772973  0.02347428  0.01063703  0.02542274],-0.6213848480741647
118,BJBR.JK,967,241,0.6348547717842323,414,553,[ 0.00059578 -0.02165309 -0.01747    -0.00176416 -0.0115316   0.18824001],-0.2930333635056588
119,BJTM.JK,967,241,0.7427385892116183,349,618,"[-3.30715972e-02 -5.86550042e-03 -1.29917438e-02  3.18581511e-03
  9.91169193e-04 -1.12621846e+00]",-0.5658853627289053
120,BKDP.JK,951,237,0.70042194092827,217,734,[-0.15923642  0.05169319 -0.00648418 -0.01692601 -0.01743489 -2.21015861],-1.2267098844766138
121,BKSL.JK,814,203,0.8226600985221675,234,580,[-0.03355628 -0.02935879 -0.00367686  0.19941821 -0.00845411 -1.27730642],-0.9139962590828495
122,BLTZ.JK,839,209,0.7129186602870813,151,688,[-0.06480802  0.04114608 -0.015879    0.06216722  0.03854343 -0.00148307],-1.5223871390656478
123,BLUE.JK,730,182,0.6813186813186813,289,441,"[-4.00040091e-04 -3.04017237e-05 -3.62366152e-02  3.54727390e-03
  1.22105533e-02 -1.06974119e+00]",-0.41193859410109007
124,BMAS.JK,967,241,0.5933609958506224,288,679,[-0.01324584 -0.01201611 -0.00860573 -0.0099122   0.00078776  0.16458064],-0.8641299510492098
125,BMBL.JK,37,9,0.7777777777777778,12,25,[-0.01153804  0.0009993   0.02278484  0.18054104 -0.3502098   0.83388085],-0.8031257668836521
126,BMHS.JK,339,84,0.6904761904761905,110,229,[-0.05680204  0.07025879  0.03876711 -0.02424158  0.01545172 -0.10765648],-0.7418005670871632
127,BMRI.JK,968,241,0.5145228215767634,437,531,[-0.07856685  0.00168674  0.15678688 -0.01757198 -0.01013095 -0.19613906],-0.2000561114536943
128,BMSR.JK,967,241,0.6680497925311203,335,632,[-0.44017014 -0.00133662 -0.00113883  0.02182837  0.01344889 -0.79911076],-0.628553902410484
129,BMTR.JK,966,241,0.6099585062240664,356,610,[-0.08130511 -0.01660869 -0.00525602 -0.01309719  0.0139996   0.00305118],-0.5431040092407775
130,BNBA.JK,967,241,0.6431535269709544,362,605,[ 0.12691813 -0.01817619 -0.00835075  0.00462477 -0.03177357 -0.61723685],-0.5136035584038441
131,BNBR.JK,268,67,0.6417910447761194,56,212,[ 0.13692037 -0.13394711 -0.08837996 -0.07042578  0.01397035 -0.00600339],-1.4046369931286973
132,BNGA.JK,967,241,0.6265560165975104,364,603,[-0.12086326 -0.02337912  0.01611613 -0.06557367  0.01386159  0.3984781 ],-0.5089670383639988
133,BNII.JK,967,241,0.7136929460580913,331,636,[-0.1386099   0.00765026 -0.02659599  0.00480837  0.00584306 -1.20427886],-0.6538264217151537
134,BNLI.JK,967,241,0.6597510373443983,368,599,[ 0.01436708 -0.02812627 -0.01554349  0.01069072  0.00644018  0.3089359 ],-0.4929403699908113
135,BOBA.JK,275,68,0.6323529411764706,89,186,[-0.05029096  0.04012663 -0.06418716 -0.17302884  0.03571824 -0.85161452],-0.734806469938354
136,BOGA.JK,967,241,0.6348547717842323,354,613,[-0.05828669  0.01293334 -0.01721779 -0.04063501 -0.01160871  1.20251492],-0.5654666949151459
137,BOLA.JK,741,185,0.6648648648648648,278,463,[-0.01308581  0.02990238 -0.02162731  0.06404333  0.02129887 -1.26147104],-0.5083378888426014
138,BOLT.JK,964,241,0.6556016597510373,268,696,"[-2.36484039e-05 -1.22724875e-04  4.08781106e-03  6.61985256e-03
 -6.19140310e-03 -1.95185488e-03]",-0.012885787464236114
139,BOSS.JK,967,241,0.6680497925311203,327,640,[ 0.00601928 -0.0090855   0.00226324  0.06352877  0.00431922  0.22180309],-0.6716850907898967
140,BPFI.JK,812,203,0.6945812807881774,109,703,[ 0.12732666 -0.02355784  0.10519212  0.05948673  0.03941631 -0.13434404],-1.8755286245997966
141,BPII.JK,511,127,0.8976377952755905,39,472,[0. 0. 0. 0. 0. 0.],0.0
142,BPTR.JK,936,234,0.6581196581196581,313,623,"[-4.88234719e-02  1.78552890e-02  4.50730213e-02  2.21025521e-02
 -1.32654914e-03 -2.10539338e+00]",-0.6886833260173504
143,BRAM.JK,938,234,0.6923076923076923,166,772,[ 0.15902972 -0.00297318 -0.01088347  0.00296455  0.00807632  0.20139717],-1.5435151968151102
144,BRIS.JK,967,241,0.6016597510373444,342,625,[ 0.2291185   0.02230063 -0.0112039   0.1255094   0.01729607 -0.0922815 ],-0.5994054320354382
145,BRMS.JK,788,197,0.6294416243654822,230,558,"[ 2.92242827e-02  4.11715260e-02  6.92383463e-03 -5.50804658e-03
  8.01083104e-04 -8.93905943e-01]",-0.8836583747573594
146,BRNA.JK,964,240,0.8541666666666666,189,775,[-0.03204566 -0.00810195  0.03216874 -0.00335239  0.00100156 -0.57173193],-1.4114746237492641
147,BRPT.JK,968,241,0.5933609958506224,417,551,"[ 8.29117730e-02 -2.46872990e-05 -3.39971695e-02  1.47802888e-01
  1.29702810e-02 -5.94449096e-01]",-0.2751188202429766
148,BSBK.JK,66,16,1.0,12,54,[-0.03863331  0.21744037  0.3354727   1.03029519 -0.26233376  0.22611234],-1.5359346953352597
149,BSDE.JK,966,241,0.5892116182572614,392,574,[-0.01017704 -0.00156416  0.01067563 -0.00282808  0.0056414  -0.64932877],-0.3821772557485492
150,BSIM.JK,965,241,0.6763485477178424,309,656,"[-2.79800971e-01 -3.38428262e-02 -3.31757682e-02  3.80879242e-02
  9.12071813e-05 -1.47145678e+00]",-0.7515537269713102
151,BSML.JK,248,62,0.7580645161290323,87,161,[-0.00883653  0.00416606 -0.044951   -0.00315434  0.00326038  0.39405461],-0.6176595103911877
152,BSSR.JK,967,241,0.5228215767634855,349,618,[-0.00569964  0.0173439   0.03925341  0.00438535  0.0154418  -1.03770901],-0.5618356599049978
153,BTEK.JK,307,76,0.7368421052631579,118,189,[-0.14823668  0.04604087 -0.01052945  0.01437969  0.14917361 -1.40084354],-0.45956251173630674
154,BTON.JK,967,241,0.6224066390041494,353,614,"[-2.21654841e-01  3.74185017e-03  1.46154782e-02 -5.11600026e-03
 -8.89162281e-04 -3.46017136e+00]",-0.5536877745583911
155,BTPN.JK,967,241,0.6265560165975104,386,581,"[-1.90284769e-02  2.52593631e-02 -7.80787434e-03 -7.26610057e-04
 -2.09164068e-03 -8.41869301e-01]",-0.40740853433802604
156,BTPS.JK,967,241,0.6182572614107884,433,534,[ 0.00468595 -0.01523987 -0.00342671  0.07026368  0.00346972  0.29669592],-0.2119057653812706
157,BUAH.JK,125,31,0.1935483870967742,56,69,[ 0.02745508  0.02043373  0.12347135  0.18532817 -0.04547126  0.16055742],-0.20920063847130577
158,BUDI.JK,967,241,0.6680497925311203,322,645,"[-2.21516802e-02 -1.05105862e-05 -2.15956766e-02  6.25931505e-03
 -3.27067674e-03 -1.35815139e+00]",-0.6957656296038114
159,BUKA.JK,321,80,0.6625,124,197,[ 0.00454869 -0.02294116  0.25488004  0.06181301 -0.01079481 -0.21884175],-0.4711657313030511
160,BUKK.JK,966,241,0.6307053941908713,356,610,[-0.25461839 -0.06891054  0.0243514   0.23100913 -0.00759674 -1.57561084],-0.5297110366566912
161,BULL.JK,968,241,0.5850622406639004,386,582,[-0.00816555  0.01659909 -0.00044121 -0.00792569 -0.00221737 -0.18598677],-0.4070336820319204
162,BUMI.JK,884,221,0.5610859728506787,266,618,[0.04286056 0.00494449 0.0394246  0.02826229 0.01620425 0.20820294],-0.8483683555140591
163,BUVA.JK,624,156,0.7371794871794872,205,419,[-0.05519301 -0.02608955 -0.01089117 -0.0449884  -0.0125568  -0.98696215],-0.7143782035850519
164,BVIC.JK,966,241,0.6514522821576764,332,634,"[-2.84075505e-01 -2.71581396e-02  1.19458244e-02  1.58742092e-01
 -4.58398300e-04 -7.64305041e-01]",-0.6449336914512227
165,BWPT.JK,967,241,0.7178423236514523,345,622,[-0.0925352  -0.02110309 -0.01825254 -0.05703886  0.00054407  0.03928235],-0.5897469918454779
166,BYAN.JK,937,234,0.48717948717948717,285,652,"[ 3.18623304e-01 -1.70403275e-05 -5.13144429e-05 -2.15668261e-02
  5.81032081e-03 -1.27943230e-01]",-0.8293815316362141
167,CAKK.JK,804,200,0.645,237,567,[ 0.16198715 -0.02434663 -0.03577848  0.13014349 -0.00305328 -1.44386554],-0.8776797708535177
168,CAMP.JK,967,241,0.5975103734439834,355,612,[ 0.00597972  0.00585528 -0.01821156 -0.05638358 -0.00096045 -0.51542167],-0.5377395060774646
169,CANI.JK,964,240,0.65,254,710,[-0.46972318  0.08548301 -0.00062302  0.01061176  0.02606717  0.19774704],-1.033602899551955
170,CARE.JK,588,147,0.5918367346938775,220,368,[-0.03227205  0.01116911 -0.08365261  0.00389584  0.11028841  0.32444527],-0.5232620681449283
171,CARS.JK,542,135,0.7037037037037037,177,365,"[ 1.26648992e-02  1.91738937e-05 -2.72480391e-04  2.98684407e-01
 -5.24344160e-04 -4.41230779e-02]",-0.7332074922136024
172,CASA.JK,964,241,0.6763485477178424,275,689,[-0.00309939 -0.02774394  0.00294048 -0.01929003  0.03096857 -0.44330191],-0.9116215270668108
173,CASH.JK,564,140,0.65,204,360,[ 0.01005806  0.11216367 -0.28654531  0.07677835  0.03174303  0.52124546],-0.5744285487063928
174,CASS.JK,966,241,0.5601659751037344,254,712,[-0.02059266 -0.0187497   0.04967645  0.04347838 -0.00281432 -1.11145605],-1.0297345792302428
175,CBMF.JK,472,118,0.864406779661017,150,322,[ 0.52251162  0.00940314  0.00347594  0.05102152 -0.02226618  0.19342018],-0.7793426266625468
176,CBPE.JK,40,9,0.7777777777777778,16,24,[-0.00869613 -0.17878042  0.1100335   0.80521402  0.01059298 -0.2830242 ],-0.402953578230416
177,CBRE.JK,39,9,1.0,9,30,[ 0.00568427  0.19593122  0.05644715 -0.03271127 -0.40987289 -0.23326284],-1.2233091212874994
178,CBUT.JK,74,18,0.4444444444444444,35,39,[-0.02068682  0.29362168  0.17018086 -0.53217052 -0.57788299  0.05814254],-0.10411165371216641
179,CCSI.JK,741,185,0.7297297297297297,282,459,[-0.0138026   0.01420349  0.08660101 -0.05614803 -0.00765178 -1.37747799],-0.48436658559113194
180,CEKA.JK,967,241,0.6431535269709544,392,575,[-0.02145174 -0.03434084  0.00673423 -0.04255331  0.00920215 -1.37494642],-0.3731061432947548
181,CENT.JK,966,241,0.7178423236514523,332,634,[ 0.07608142 -0.07483299 -0.03066391  0.09434185  0.00348578 -1.0312702 ],-0.6487273510644741
182,CFIN.JK,966,241,0.6265560165975104,334,632,[-0.02907889  0.021152   -0.03380668  0.03394948  0.00240485 -1.23315819],-0.6409410523537887
183,CHEM.JK,143,35,0.6,46,97,[-0.10037557  0.07057452  0.04618969 -0.44588948 -0.00162738 -0.3536131 ],-0.7526583252669832
184,CHIP.JK,22,5,0.4,9,13,[-0.02355485 -0.07759827  0.02844239 -0.09933704  0.28132498  0.21161468],-0.44343175858633743
185,CINT.JK,967,241,0.7344398340248963,309,658,"[-2.76395741e-01 -8.46997717e-02  8.22065939e-03  1.36270428e-03
  6.43149682e-03 -2.47756324e+00]",-0.7499720324552276
186,CITA.JK,968,241,0.6721991701244814,282,686,[-0.00971491  0.01108389 -0.00131736  0.00293031 -0.00343938 -0.15494138],-0.8908677113505564
187,CITY.JK,889,222,0.6846846846846847,291,598,"[-1.27722863e-01 -3.52744124e-04  4.95685083e-02 -4.61909141e-02
 -2.64070412e-03 -1.27673175e+00]",-0.7285334369527743
188,CLAY.JK,825,206,0.7427184466019418,246,579,[ 0.11305676 -0.0497226  -0.00506509  0.01845456  0.02193104 -1.09402349],-0.8497341061248305
189,CLEO.JK,967,241,0.6016597510373444,337,630,[-0.00080935  0.00631747  0.00775142  0.00090756  0.01125809  0.01139662],-0.6220724475187696
190,CLPI.JK,967,241,0.6763485477178424,343,624,[ 0.00519807 -0.01230573 -0.00865582 -0.0182723   0.01027418 -1.83146636],-0.5987221645795163
191,CMNP.JK,967,241,0.6514522821576764,382,585,[-0.00918639  0.04765763  0.01420169 -0.01372084  0.00815028 -0.21726977],-0.421851094688053
192,CMNT.JK,304,76,0.7105263157894737,114,190,[-0.00805872  0.01383411 -0.15069161 -0.0215497   0.00182356  0.17877104],-0.5261609029533498
193,CMPP.JK,509,127,0.6850393700787402,152,357,[ 0.00695388 -0.00435899  0.1079843  -0.04618891  0.01013874  0.40252803],-0.8637079779180968
194,CMRY.JK,255,63,0.5079365079365079,118,137,[-0.07894471 -0.01763426  0.00555684 -0.16644997 -0.00292902 -0.11031437],-0.13687355828687467
195,CNTX.JK,966,241,0.7385892116182573,238,728,"[-4.00556951e-01  3.18199938e-02  2.65598844e-02  2.82036973e-04
  2.35925510e-02 -2.62513322e+00]",-1.127132357982677
196,COAL.JK,109,27,0.6296296296296297,31,78,[-0.02232709  0.57656568  0.03962068 -0.23428888  0.42604329  0.95352492],-0.949383607138188
197,COCO.JK,792,197,0.6142131979695431,241,551,[-0.05975887 -0.05427144  0.02373292  0.02157457  0.00072928 -0.32242482],-0.8230808939698087
198,COWL.JK,310,77,0.8831168831168831,93,217,[-0.07267872  0.23321606  0.03538051  0.08622091 -0.08027089 -0.49089627],-0.8804276830804355
199,CPIN.JK,967,241,0.5518672199170125,432,535,[-0.01272695  0.0025187  -0.00243122 -0.00255894 -0.00374546 -0.73817082],-0.21528447095912895
200,CPRI.JK,120,30,0.9666666666666667,24,96,[-0.02617664 -0.29567981  0.756348    0.33452342 -0.11861324 -0.49142951],-1.3849384270911562
201,CPRO.JK,308,76,0.8289473684210527,88,220,[ 0.10289629 -0.04428581  0.16924736  0.0136896   0.00118606 -0.74288693],-0.9343242217372613
202,CRAB.JK,124,30,0.7,41,83,[-0.02819733  0.25502844 -0.92285438 -0.65101769  0.56587179 -0.99677739],-0.6754673559517765
203,CSAP.JK,967,241,0.6182572614107884,310,657,[-0.10483983  0.02825184  0.00376489  0.04295918  0.02105333 -1.62539993],-0.753602775668765
204,CSIS.JK,915,228,0.706140350877193,272,643,[ 0.0525721   0.013857   -0.01812829  0.04372397 -0.00905793 -0.84056109],-0.8630031531633187
205,CSMI.JK,430,107,0.9252336448598131,122,308,[ 0.22586067  0.02712154  0.51546953  0.00923823 -0.04793911 -0.21177846],-0.9306011772072197
206,CSRA.JK,626,156,0.6025641025641025,229,397,[-0.06586891 -0.00898536  0.16425039  0.04889378 -0.02860489 -0.08194721],-0.5549119200292333
207,CTBN.JK,608,151,0.6821192052980133,120,488,[-0.3368018   0.02195378  0.01737473 -0.0460114  -0.01628718  0.00097539],-1.416106055205275
208,CTRA.JK,967,241,0.6265560165975104,400,567,[ 0.0682528   0.06065137 -0.04300468  0.03676081 -0.00362294 -0.02358454],-0.3483907720148768
209,CTTH.JK,682,170,0.8647058823529412,186,496,[-0.12510752 -0.03655223  0.16854941 -0.23801753 -0.01048431 -1.9103912 ],-1.0001789742463032
210,CUAN.JK,6,1,0.0,3,3,[-0.00704703  0.48266099 -0.0944054  -0.03102811 -0.04012366 -0.05371804],-0.062151236659043076
211,DADA.JK,270,67,0.9850746268656716,47,223,[-0.1283085   0.25922133 -0.09372005  0.0658924   0.12510307  0.68284369],-1.590714224700645
212,DART.JK,967,241,0.6514522821576764,251,716,[-0.36041449 -0.00885915  0.00799674 -0.0111546   0.00874753 -1.00074529],-1.0490580010236934
213,DAYA.JK,966,241,0.5892116182572614,213,753,[-0.50470179 -0.02423696 -0.01041746 -0.05420846  0.03547139  0.06176137],-1.2687662598773823
214,DCII.JK,424,106,0.9056603773584906,96,328,[ 0.33655156 -0.02502572 -0.00067744  0.1220611   0.00931129  0.32092225],-1.2414928050645495
215,DEAL.JK,548,136,0.75,214,334,[ 0.51618813  0.16333139 -0.0086568  -0.24399404  0.0114021   1.16663894],-0.45924770075154364
216,DEFI.JK,724,180,0.7722222222222223,192,532,[ 0.15349894 -0.03395843 -0.00088021 -0.05084227 -0.00188838  0.52455143],-1.0310239156101928
217,DEPO.JK,260,65,0.7538461538461538,104,156,[-0.04066808  0.02214206  0.01679683  0.00419864  0.00473571 -0.9645829 ],-0.38154688762067435
218,DEWA.JK,232,57,0.8421052631578947,71,161,[-0.01026317 -0.07928263 -0.0182775   0.01621459  0.01650384 -0.29353284],-0.8220312373035785
219,DEWI.JK,138,34,0.5,65,73,[-0.07434166 -0.0364394  -0.0434099  -0.03209654 -0.01851945 -0.30699252],-0.10813645152877811
220,DFAM.JK,965,241,0.7510373443983402,315,650,[ 0.21467585 -0.01197059 -0.09238342  0.01123628 -0.00640273 -1.46351599],-0.7262401129876813
221,DGIK.JK,484,121,0.6776859504132231,167,317,[ 0.11938744  0.06977266  0.02279818  0.03466062  0.04232887 -0.3153889 ],-0.6291546469404325
222,DGNS.JK,430,107,0.6822429906542056,163,267,[-0.00865256  0.01680341 -0.18885871 -0.23046117  0.00990833 -0.42641241],-0.5032938001456052
223,DIGI.JK,752,187,0.732620320855615,182,570,"[-1.29445944e-01 -9.65738245e-04 -5.99820927e-02 -3.31170545e-02
 -3.54525300e-02 -1.44803698e+00]",-1.1584337532270301
224,DILD.JK,967,241,0.6473029045643154,338,629,[-0.00342716  0.02251299  0.02428248 -0.00560724  0.00720739 -0.87259819],-0.6164122983392017
225,DIVA.JK,856,214,0.5841121495327103,331,525,[ 0.23963676  0.05486816 -0.13784097  0.12123811  0.00665101  0.80068578],-0.4595933898750282
226,DKFT.JK,967,241,0.6431535269709544,341,626,[-0.16351806 -0.01428125  0.07765137  0.05002844  0.00244311 -1.21417452],-0.6012687289015756
227,DLTA.JK,967,241,0.6182572614107884,315,652,"[-1.35265903e-03 -3.68851574e-03  3.84146771e-02  1.02674570e-03
  1.04399323e-02 -1.20839675e+00]",-0.7282883004411767
228,DMAS.JK,966,241,0.6763485477178424,378,588,"[-1.23886996e-02 -2.13847171e-02 -9.54100726e-03 -4.46405996e-02
  8.85027551e-04 -1.01801512e+00]",-0.43533596839591093
229,DMMX.JK,670,167,0.6287425149700598,283,387,[ 0.88655236 -0.03803194 -0.2466767   0.00209236 -0.00799103  0.09482862],-0.329176188147557
230,DMND.JK,618,154,0.7532467532467533,205,413,[-0.13281439 -0.00604372 -0.03383229  0.26087387  0.00867242 -2.77957496],-0.7039077677395889
231,DNAR.JK,967,241,0.6556016597510373,295,672,[-0.16055153 -0.00636271 -0.02499201  0.03372753  0.01851946 -0.61541308],-0.8303188086488323
232,DNET.JK,964,241,0.6597510373443983,237,727,"[-1.06103485e-01  4.77451761e-02 -1.48312030e-04 -8.00842520e-02
 -1.10992340e-03 -1.55953696e+00]",-1.1172954338169088
233,DOID.JK,967,241,0.5560165975103735,365,602,[-0.00635565 -0.00302561  0.03312529  0.04754942 -0.00280907 -1.03206771],-0.49798867707481
234,DPNS.JK,968,241,0.6016597510373444,261,707,[-0.00582231  0.01359838 -0.01524106 -0.00186939 -0.03199161 -1.41076512],-1.0024234344739729
235,DPUM.JK,508,126,0.8015873015873016,135,373,[-0.1335644   0.05959247 -0.01451896 -0.01422012  0.0521592   0.09313095],-1.0412176366072985
236,DRMA.JK,247,61,0.5245901639344263,99,148,[-0.03179362 -0.01027395 -0.08592776 -0.2276551  -0.02269617 -0.61132254],-0.43488989746411283
237,DSFI.JK,964,240,0.6916666666666667,315,649,[-0.25349539  0.00360294  0.00666278 -0.02380024  0.00312867 -2.24271705],-0.7189006262699519
238,DSNG.JK,966,241,0.6016597510373444,345,621,[-0.07054414  0.01694274  0.01228134 -0.01227407 -0.00386594 -0.18649932],-0.5898530622157999
239,DSSA.JK,904,225,0.9111111111111111,126,778,[0.09493752 0.01437955 0.03836544 0.00297136 0.0004306  0.00900832],-1.8258034164230426
240,DUCK.JK,567,141,0.7446808510638298,193,374,[ 0.19639313 -0.03405184  0.10341325  0.04270192  0.00192935  0.68285794],-0.6603705965017858
241,DUTI.JK,884,220,0.6545454545454545,184,700,[-0.06195989  0.03524398 -0.01574642  0.01273996  0.00274489 -0.05767592],-1.3311722723905555
242,DVLA.JK,967,241,0.6804979253112033,307,660,"[-1.43897455e-01  5.03454443e-02  1.25129942e-02  6.05285611e-03
 -8.96592447e-06 -3.11760552e+00]",-0.7719224117553323
243,DWGL.JK,966,241,0.6016597510373444,340,626,"[-1.61358278e-02  9.76340920e-04  5.87912696e-04 -1.07829903e-02
  3.27049703e-04 -1.28690532e+00]",-0.6089470020424473
244,DYAN.JK,910,227,0.6343612334801763,282,628,[-0.17375057 -0.06536652  0.10775066 -0.05936604 -0.00443239 -1.24155753],-0.7977644804420114
245,EAST.JK,729,182,0.6373626373626373,242,487,[ 0.04794484 -0.00762323 -0.01205103  0.03117042 -0.05133198 -0.71399321],-0.6959991669126558
246,ECII.JK,938,234,0.8205128205128205,107,831,[-0.08482898 -0.00115959 -0.00153985 -0.0371135   0.00499538  0.01952745],-2.0510544623858262
247,EDGE.JK,417,104,0.8269230769230769,142,275,[-0.06925065 -0.05978269 -0.12906308  0.05098871  0.01007715 -1.30983471],-0.6719132236053054
248,EKAD.JK,968,241,0.7136929460580913,375,593,[-0.01055984 -0.00667429 -0.01553485 -0.05832578 -0.03673964 -0.92415668],-0.4499702240117225
249,ELIT.JK,40,9,0.3333333333333333,19,21,[-0.01161643 -0.34991627 -0.33396497 -0.01141375 -0.03444411 -0.260742  ],-0.07446863061032626
250,ELPI.JK,126,31,0.6774193548387096,44,82,[-0.00776716 -0.12316914 -0.3096413  -0.32684249 -0.09160642 -0.83068913],-0.6354240433244807
251,ELSA.JK,967,241,0.5684647302904564,378,589,"[-8.09259343e-02 -1.04611074e-01 -1.56631497e-04 -2.60570038e-02
 -1.28570448e-02 -1.08646605e+00]",-0.44032164558229037
252,EMDE.JK,948,237,0.6919831223628692,166,782,[-0.16519463 -0.04933247  0.05134707  0.0051904   0.01293037 -0.06708273],-1.5641960227560652
253,EMTK.JK,968,241,0.6224066390041494,280,688,[ 0.0951551  -0.02113848 -0.00659471 -0.01753517 -0.0038072  -0.62002841],-0.890774061945023
254,ENAK.JK,220,54,0.5740740740740741,95,125,[ 0.044827   -0.03578071 -0.13726224  0.10638168  0.00432718  1.69002366],-0.30281246924970734
255,ENRG.JK,939,234,0.5854700854700855,292,647,[ 0.15696519 -0.06093983 -0.00872504 -0.01120661  0.00081214 -0.56473362],-0.7938806677207381
256,ENVY.JK,264,66,0.9242424242424242,84,180,[0.45688521 0.48287626 0.03920305 0.06313019 0.11721552 1.28518902],-0.7625978723117628
257,ENZO.JK,272,68,0.7794117647058824,67,205,[ 0.01065339  0.01355392  0.07730023  0.10760195 -0.00639585 -0.93915323],-1.1131806034003073
258,EPAC.JK,312,77,0.8571428571428571,85,227,[ 0.01756908  0.08015136 -0.05680026 -0.11999844 -0.04750716 -0.53427732],-0.9858401625794848
259,EPMT.JK,967,241,0.6099585062240664,275,692,"[-2.84504647e-12  4.83750579e-09  9.53095299e-10 -3.76296233e-10
  1.22377649e-09 -2.86706434e-10]",-2.9356942586338816e-09
260,ERAA.JK,968,241,0.6058091286307054,399,569,"[-2.83086754e-02 -4.65400141e-03 -1.08850301e-02  7.81539673e-04
 -5.77864181e-03 -9.36237504e-01]",-0.3491684719823128
261,ERTX.JK,967,241,0.6307053941908713,310,657,"[-4.76600297e-01  8.77570940e-04  1.28944415e-02  6.29059327e-03
  1.83054520e-02 -1.94028095e+00]",-0.7506947904372713
262,ESIP.JK,656,163,0.7791411042944786,218,438,[-0.15047518  0.00138137  0.0188588   0.01988228  0.00457978 -0.10900578],-0.6955706431160631
263,ESSA.JK,967,241,0.5809128630705395,376,591,"[-3.51782654e-02  6.04379768e-04 -4.27353779e-02 -8.21617175e-03
  7.04829985e-03 -1.03909650e+00]",-0.44935045308130184
264,ESTA.JK,592,148,0.6824324324324325,222,370,[-0.01378156 -0.11929501  0.00698542 -0.00265961  0.00110865 -0.56727313],-0.5193470671973036
265,ESTI.JK,911,227,0.8149779735682819,282,629,[-0.01954135 -0.0262048   0.01477795  0.01313709 -0.00518934 -0.54603662],-0.8022602027585907
266,ETWA.JK,598,149,0.5704697986577181,176,422,[ 0.44171724  0.01668781 -0.00263795  0.27084624 -0.03502829 -1.433045  ],-0.8831407270562041
267,EURO.JK,126,31,0.3870967741935484,69,57,[ 0.12307453 -0.32685831  0.71131605  0.09166216  0.05622096 -0.29631945],0.20469003498955884
268,EXCL.JK,967,241,0.5975103734439834,399,568,[-0.17015642 -0.06946918 -0.00548947 -0.04751676  0.00456041 -0.42740557],-0.357668980455461
269,FAPA.JK,436,109,0.6055045871559633,189,247,[-0.00629329 -0.65495019 -1.01004075 -0.34210896 -0.01465725 -1.23363728],-0.2591252523223627
270,FAST.JK,968,241,0.7385892116182573,288,680,[-0.18812935  0.03869727 -0.01818391 -0.02005409  0.00473284 -1.14749381],-0.8535477001502245
271,FASW.JK,818,204,0.8480392156862745,189,629,[ 0.01703901 -0.04645728  0.01956519 -0.0413948  -0.02016394  0.0708024 ],-1.2017103951230488
272,FILM.JK,920,230,0.5304347826086957,369,551,[ 0.50007288  0.02714181 -0.00756681 -0.16323792  0.01173412  0.23467022],-0.3996782309366796
273,FIMP.JK,384,95,0.7157894736842105,118,266,[ 0.04566633  0.00636108  0.12293778  0.01827348  0.04859154 -0.93730618],-0.8224278579972203
274,FIRE.JK,967,241,0.7302904564315352,312,655,[-0.0621022  -0.00930114  0.0182571   0.13052624  0.00243631 -0.34531646],-0.748704387641125
275,FISH.JK,966,241,0.7717842323651453,136,830,[ 0.16003635 -0.00918352  0.00038678 -0.04095619 -0.01596254  0.32824112],-1.8268537589585112
276,FITT.JK,744,186,0.6505376344086021,239,505,[ 0.17783657  0.01979588 -0.09326496 -0.03566433  0.00238528 -0.20006451],-0.7568930328156755
277,FLMC.JK,200,49,0.7959183673469388,71,129,[ 0.16261106 -0.22320708  0.04580905  0.01565625 -0.01375947  1.18421361],-0.5963736634463218
278,FMII.JK,901,225,0.6977777777777778,205,696,[-0.2510166   0.05288783  0.05926084 -0.05322899  0.00117731  0.05436442],-1.2406455138245478
279,FOOD.JK,831,207,0.6231884057971014,259,572,[-0.22570575 -0.03005225 -0.04696796  0.00749794 -0.02072976  0.05531978],-0.7913397916401967
280,FORU.JK,960,240,0.6625,232,728,[-0.03946867  0.02718002 -0.01927043  0.00250741 -0.0163236  -1.33016237],-1.149722433348654
281,FORZ.JK,319,79,0.810126582278481,115,204,[-0.006614    0.0143396  -0.19697536  0.29719329  0.04056687  0.43346765],-0.596224436451422
282,FPNI.JK,967,241,0.6307053941908713,344,623,"[-1.45921284e-01  9.11519665e-02 -1.60428456e-02  3.04959259e-02
  1.25565319e-04 -4.85380826e-01]",-0.5948888052321745
283,FREN.JK,967,241,0.7095435684647303,367,600,[-0.01169555  0.01338536  0.00918333 -0.00708483  0.00116285 -0.86358308],-0.4848697996084283
284,FUJI.JK,727,181,0.6574585635359116,279,448,"[-6.51394112e-02 -1.49152715e-02 -4.62183316e-02  6.34600682e-02
 -2.09388420e-03 -2.96490448e+00]",-0.4742442709892004
285,FUTR.JK,12,2,1.0,5,7,[-0.00578978  0.18805597  0.07770069  0.0463711  -0.07065124  0.01598037],-0.3264707409266344
286,FWCT.JK,26,6,0.5,6,20,"[-7.26769719e-04 -6.97430089e-02 -4.36847632e-02  3.05086339e-03
 -8.97947892e-01 -1.06613555e-01]",-1.3392951253456364
287,GAMA.JK,248,61,0.9836065573770492,34,214,[-0.00570749  0.03009491  0.03263517  0.05400399 -0.11170131 -1.50671109],-2.00398785301275
288,GDST.JK,967,241,0.6597510373443983,308,659,[-0.04256136 -0.05883938 -0.01407887  0.03028668  0.00144548 -1.26300588],-0.7655683392056262
289,GDYR.JK,891,222,0.6351351351351351,195,696,[-0.00266636  0.00047826  0.02706426  0.07916647 -0.002684   -0.16005121],-1.2741051961975318
290,GEMA.JK,966,241,0.7302904564315352,223,743,[-0.2176026  -0.00461423 -0.06532884  0.00429387  0.00237691 -1.17957796],-1.2042638465136601
291,GEMS.JK,492,123,0.6910569105691057,161,331,[-0.00805483 -0.06695371 -0.20211052 -0.12876593  0.00680897  0.80900521],-0.720157717020076
292,GGRM.JK,967,241,0.5726141078838174,418,549,[-0.00805605  0.05255538  0.07133738 -0.03620198 -0.00452678 -0.17089906],-0.2717398438877805
293,GGRP.JK,688,171,0.6608187134502924,269,419,[-0.11664868 -0.03279843  0.01241769  0.00418419 -0.00888681 -0.826859  ],-0.4383640024946825
294,GHON.JK,967,241,0.6721991701244814,289,678,[-0.46703226 -0.00499979 -0.00167786 -0.0020388   0.00644662 -1.55750031],-0.8464405053469963
295,GIAA.JK,694,173,0.7687861271676301,241,453,[ 0.01873406 -0.00688113  0.00685581 -0.00370165 -0.0045791   0.39647159],-0.6325615672326598
296,GJTL.JK,967,241,0.6182572614107884,367,600,[-0.13408248  0.00887081  0.01623411 -0.019159    0.01399425 -0.19495553],-0.48689023319799873
297,GLOB.JK,967,241,0.6887966804979253,321,646,"[-5.27545113e-01 -1.43193573e-04 -9.93611141e-02 -1.81286365e-03
  4.22539357e-02 -6.71409450e-01]",-0.6976983842573036
298,GLVA.JK,634,158,0.5189873417721519,225,409,"[-2.09294334e-01 -9.46761837e-03 -7.27294507e-02  1.93125868e-03
 -4.02527460e-03 -2.33832663e+00]",-0.5919305124396916
299,GMFI.JK,966,241,0.7676348547717843,313,653,[-0.00309218  0.01641567 -0.03447727 -0.0120861   0.00510615 -0.84168341],-0.7315977095557865
300,GMTD.JK,603,150,1.0,71,532,[-0.15294259  0.09910706 -0.04705366 -0.09899484 -0.02831946 -0.36022625],-2.058955148610097
301,GOLD.JK,968,241,0.6431535269709544,296,672,[-0.41547805  0.0065167  -0.00795859 -0.01008657 -0.00345243 -2.62469901],-0.8316397575960378
302,GOOD.JK,884,221,0.6515837104072398,343,541,[-0.12254171 -0.14613128  0.3458197   0.03956119 -0.00222501 -0.25217077],-0.4609269139122376
303,GOTO.JK,186,46,0.5652173913043478,67,119,[ 0.07226616 -0.01499929 -0.39886582  0.15193595 -0.05883232 -0.23062085],-0.5946006090966593
304,GPRA.JK,964,241,0.6680497925311203,281,683,"[-9.05080417e-02 -1.26574522e-02 -2.58243301e-05 -3.43353448e-02
  9.41266999e-03 -2.13527382e+00]",-0.8934320852054214
305,GPSO.JK,306,76,0.6447368421052632,104,202,[-0.12424161  0.01016767  0.05934864  0.18122641 -0.00083362 -0.78495062],-0.6556048244985883
306,GSMF.JK,964,240,0.6916666666666667,272,692,[-0.3084714  -0.03661658 -0.00260182  0.05213826  0.00909622  0.07698493],-0.9460049675726873
307,GTBO.JK,511,127,0.6141732283464567,171,340,[-0.16464345 -0.00400452 -0.04379358 -0.22697983  0.0644064  -2.01966292],-0.6924659945352497
308,GTSI.JK,304,76,0.8552631578947368,80,224,[-0.07612175 -0.02124556  0.00516826  0.03946218  0.17340866  0.33479324],-1.041327355181934
309,GULA.JK,128,32,0.59375,63,65,[ 0.02684763 -1.09972159  0.30587863 -0.00777606 -0.01712651 -0.75336551],0.022280389725865726
310,GWSA.JK,965,241,0.6016597510373444,323,642,"[-4.45913635e-02 -1.54874198e-02 -9.94369033e-02  2.56349268e-02
  1.53932447e-03 -1.91452388e+00]",-0.6853561075691108
311,GZCO.JK,570,142,0.5915492957746479,153,417,[ 0.10084121 -0.0488291  -0.1602612   0.01316795  0.01694124 -1.19694439],-1.017993100996862
312,HAIS.JK,308,77,0.6233766233766234,110,198,[-0.08378797 -0.18569014 -0.00471161 -0.0312699  -0.05032071  0.10196903],-0.5826406923372953
313,HALO.JK,22,5,0.2,12,10,[ 0.05103869 -0.29837891  0.44330435  0.25853257 -0.70341029  0.16661478],0.35619484974024385
314,HATM.JK,133,33,0.5757575757575758,39,94,[-0.04888942  0.11757337 -0.176472   -0.3804129  -0.02962563 -0.21321132],-0.9046282718265796
315,HDFA.JK,957,239,0.6234309623430963,255,702,[-0.58745851 -0.01058636  0.07647839  0.0162576   0.00767544 -0.74204527],-1.0136439566824433
316,HDIT.JK,711,177,0.7796610169491526,243,468,[ 0.04578717  0.00327126  0.08285824 -0.05005359 -0.01224943 -0.3260057 ],-0.6692197916728111
317,HEAL.JK,968,241,0.5684647302904564,379,589,[ 0.00463593 -0.0686974   0.03229109  0.06983024 -0.00990251 -0.28092335],-0.44474962191631895
318,HELI.JK,966,241,0.6597510373443983,356,610,[-0.02282285 -0.00672466 -0.01167026 -0.00149523 -0.00221516 -1.46033262],-0.536130769231265
319,HERO.JK,966,241,0.6804979253112033,311,655,[-0.25369718 -0.07562737  0.016005    0.08925741  0.00203651 -1.82129769],-0.7574328574376122
320,HEXA.JK,967,241,0.6182572614107884,391,576,"[-1.23794807e-02  1.15468620e-04  1.39252960e-02  7.32892943e-03
  1.67524047e-02 -8.13573652e-01]",-0.38702002798116014
321,HILL.JK,10,2,0.0,7,3,[0.02815208 0.01239183 0.44804989 0.42992299 0.62320251 0.1167603 ],0.5625676850551329
322,HITS.JK,964,241,0.6846473029045643,258,706,"[-5.05227703e-01  1.03806089e-02 -1.58702857e-04  5.62956380e-02
 -3.19874516e-03 -8.97019216e-01]",-1.0056776100100129
323,HKMU.JK,658,164,0.7987804878048781,220,438,[ 0.09205345  0.00932345  0.01726472 -0.00325735  0.01809078 -0.77295431],-0.6837280645601866
324,HMSP.JK,968,241,0.6224066390041494,371,597,[-0.01876802  0.04523264  0.01664512 -0.01976914  0.0007384   0.35385123],-0.4829933611318558
325,HOKI.JK,968,241,0.6970954356846473,354,614,[-0.10349551 -0.00649562 -0.02074092  0.02063961  0.00402602 -0.43283348],-0.5484447099247914
326,HOME.JK,300,74,0.8108108108108109,99,201,[ 0.07365643 -0.04700419  0.03602733  0.01455881  0.01743035  0.2364246 ],-0.7077988932232459
327,HOMI.JK,496,123,0.5853658536585366,245,251,[ 0.20717952 -0.04682861 -0.04350134  0.3137184   0.0290123   1.30692194],-0.04317262302040811
328,HOPE.JK,315,78,0.8205128205128205,92,223,[ 0.01945964 -0.07859501 -0.00825165  0.008323    0.04270015  0.52911529],-0.8989031965934033
329,HOTL.JK,439,109,0.8807339449541285,143,296,[-0.1049385  -0.07745178 -0.00824103 -0.00376623  0.04610251 -0.42563396],-0.719603164375067
330,HRME.JK,747,186,0.7849462365591398,217,530,[ 0.62637863  0.01768192  0.11302682 -0.00647503 -0.03122987 -0.24921044],-0.8956641580687865
331,HRTA.JK,966,241,0.6473029045643154,350,616,[-0.06418821  0.00205574  0.01983716  0.09457557  0.00623897 -0.94154299],-0.5606286183496064
332,HRUM.JK,968,241,0.5518672199170125,370,598,[ 0.19973075  0.00796775 -0.02951163  0.00519581  0.04637285 -0.04955309],-0.4782882396190929
333,IATA.JK,308,77,0.7402597402597403,99,209,[-0.09252658 -0.10239124  0.11921706 -0.09328027  0.00747758  0.28990057],-0.7501395031913896
334,IBFN.JK,742,185,0.6756756756756757,184,558,"[-2.61461140e-01 -7.92123914e-04  1.56825310e-02  4.30369571e-02
 -9.13485196e-03 -1.02463222e+00]",-1.109280764262918
335,IBOS.JK,179,44,0.5454545454545454,65,114,[ 0.06456843  0.01358229  0.1774436  -0.19494559 -0.07416965  0.13304537],-0.5638408432678295
336,IBST.JK,738,184,0.782608695652174,100,638,[ 0.30892365  0.01250659 -0.02012338  0.12439954 -0.01160802  0.00589189],-1.8749755557955459
337,ICBP.JK,967,241,0.5477178423236515,421,546,[-0.13052057 -0.01272166 -0.00477753  0.0498632  -0.00195823 -1.18480373],-0.26069520052219936
338,ICON.JK,967,241,0.7593360995850622,305,662,"[-3.53200788e-01  9.37978395e-03 -4.71281822e-02 -1.79851484e-02
 -5.27454377e-04 -3.03540386e+00]",-0.7919367809432353
339,IDEA.JK,304,75,0.6133333333333333,103,201,[-0.04255991 -0.0045312   0.0067846   0.05435674 -0.0467905   0.0055636 ],-0.6614249908940676
340,IDPR.JK,967,241,0.6182572614107884,270,697,[-0.02289782 -0.00237618  0.0046667  -0.10985916  0.0038978  -0.91049015],-0.951124354291428
341,IFII.JK,641,160,0.575,239,402,[-0.06693812  0.04229424  0.00463611  0.03408502  0.02173543 -0.96990267],-0.5225612429307043
342,IFSH.JK,644,160,0.6625,202,442,"[ 8.72321044e-02 -3.18775322e-02 -1.06936945e-01  4.26473057e-04
 -4.64643205e-02 -9.27418901e-01]",-0.7928723169560569
343,IGAR.JK,967,241,0.6556016597510373,365,602,"[-1.11662235e-01  7.44150806e-03  1.92050345e-03 -9.68438580e-04
  2.55818841e-03 -2.22613507e+00]",-0.49225602398818075
344,IIKP.JK,247,61,0.8852459016393442,90,157,[ 0.05492633  0.00819925  0.04591466  0.46250409 -0.06079516  0.03867363],-0.5935620977594387
345,IKAI.JK,379,94,0.8404255319148937,109,270,[ 0.08451994  0.04951432  0.02047503  0.0109585  -0.01055408 -0.27379902],-0.9205014480646393
346,IKAN.JK,607,151,0.7284768211920529,193,414,[ 0.20531151  0.02702045  0.04548886  0.04459195 -0.0266549  -0.16627516],-0.7777695690437048
347,IKBI.JK,967,241,0.6556016597510373,268,699,"[-2.28461596e-01 -8.76656035e-02 -2.27844969e-04  2.23815690e-03
  3.98618902e-03 -2.27141768e+00]",-0.9672475350083672
348,IMAS.JK,967,241,0.5228215767634855,359,608,[-0.00593558  0.00051019  0.01021227 -0.03812064 -0.00741936  0.18208041],-0.5279342137491911
349,IMJS.JK,967,241,0.5892116182572614,325,642,[-0.08894198 -0.0035687  -0.00574883 -0.00778956 -0.02408833 -0.11241414],-0.6813092209889998
350,IMPC.JK,967,241,0.6431535269709544,374,593,[ 0.01269714 -0.01185673 -0.07186952 -0.03213635 -0.00216754  0.07424797],-0.4583990749871905
351,INAF.JK,967,241,0.7012448132780082,350,617,[0.31670523 0.00903474 0.00984338 0.14616998 0.00955242 0.52589534],-0.5729245224628636
352,INAI.JK,965,241,0.7302904564315352,341,624,"[-2.17878982e-01  1.05989893e-05 -1.06892346e-02  3.96295316e-02
  4.15388625e-03 -3.22664962e+00]",-0.5994468713979177
353,INCF.JK,828,207,0.7729468599033816,249,579,[ 0.6560139   0.01813941 -0.06185131  0.21563926  0.04132497 -1.15031086],-0.8621035138451115
354,INCI.JK,967,241,0.6431535269709544,347,620,[-0.30504302 -0.04986188  0.03955539 -0.02597055 -0.00183118 -1.81592618],-0.5695190140863226
355,INCO.JK,967,241,0.5726141078838174,410,557,[-0.00238559  0.02630299 -0.01764624 -0.02963206 -0.01078936  0.62984518],-0.3066820388351655
356,INDF.JK,967,241,0.5767634854771784,417,550,[-0.04058136  0.00141366  0.00583233  0.00775438  0.00127148  0.0917135 ],-0.2763441453516518
357,INDO.JK,625,156,0.6346153846153846,243,382,[ 0.03964026  0.09674703 -0.00460521  0.00951729  0.00109411 -0.38491891],-0.46086590414501916
358,INDR.JK,967,241,0.6307053941908713,368,599,[-0.00422607  0.12311795 -0.01828275 -0.02868384 -0.02200515 -0.0768974 ],-0.4802938172546073
359,INDS.JK,967,241,0.5975103734439834,344,623,"[-6.12225563e-02 -1.70037600e-05 -4.10822416e-04 -8.32119901e-02
 -5.05632591e-04 -1.60247202e+00]",-0.5934945920305081
360,INDX.JK,956,238,0.6890756302521008,283,673,"[-7.28650145e-03  2.12334776e-02  8.02219344e-04 -1.18026372e-02
 -2.36232561e-02 -1.42592675e+00]",-0.8728954770449062
361,INDY.JK,967,241,0.5269709543568465,405,562,[-0.07272017 -0.03389936 -0.02525368 -0.00298449  0.02593205  0.03325118],-0.33272083833297567
362,INKP.JK,967,241,0.6058091286307054,396,571,"[-6.51934796e-02  6.79858899e-02 -3.28227980e-02  5.42868821e-02
 -2.31671448e-04 -3.30577136e-01]",-0.3599515649277486
363,INOV.JK,728,182,0.6538461538461539,277,451,[-0.17473177  0.01177725  0.08869203 -0.0069531   0.01079817 -1.34994462],-0.4846237300789077
364,INPC.JK,953,238,0.7394957983193278,249,704,"[-1.28579149e-01  1.63963755e-02  4.72993190e-03  1.05596579e-01
 -4.59387740e-04 -1.37529383e+00]",-1.0368813961181496
365,INPP.JK,962,240,0.6958333333333333,210,752,[-0.52499312 -0.01809021  0.01003204 -0.01747418  0.00267867 -1.71384422],-1.2748448651068196
366,INPS.JK,967,241,0.7510373443983402,266,701,[ 0.68296235 -0.03025799  0.02665884  0.10887265  0.00448933 -0.42471576],-0.9599857191709843
367,INRU.JK,967,241,0.6597510373443983,206,761,[-0.11395986  0.09740884 -0.01657084 -0.02145154  0.00202415 -0.11548824],-1.3106596959536128
368,INTA.JK,814,203,0.6995073891625616,207,607,[-0.1556592   0.00455658  0.11043383 -0.0372802  -0.00300642 -1.37178326],-1.0795245148799957
369,INTD.JK,967,241,0.6929460580912863,298,669,[-0.05092888 -0.02340856 -0.00706836 -0.00129649  0.00748208 -0.68086653],-0.8116381967477274
370,INTP.JK,967,241,0.5518672199170125,428,539,"[-4.44156109e-02 -1.66634023e-02  1.43724588e-02  8.01639293e-02
 -1.09804257e-04 -6.37123546e-01]",-0.22382826679569418
371,IPAC.JK,342,85,0.6588235294117647,114,228,[ 0.1957087  -0.04927517 -0.02932816 -0.00220654  0.00294941 -0.81521598],-0.7069138073560381
372,IPCC.JK,937,234,0.6196581196581197,348,589,[-0.00518445 -0.02799059  0.02352038  0.04709115 -0.00492668 -0.47565142],-0.5249169028086828
373,IPCM.JK,967,241,0.6804979253112033,358,609,[ 0.10010975  0.04101937 -0.02393858 -0.00276377 -0.00575205 -0.24918283],-0.5349281854035729
374,IPOL.JK,966,241,0.6390041493775933,336,630,[-0.09707993 -0.02027862 -0.00394374  0.03229796  0.00800528 -2.39552304],-0.6270101762281096
375,IPPE.JK,237,59,0.9322033898305084,86,151,[ 0.09774537 -0.08786525 -0.07133468  0.10194574 -0.03860443  0.00645966],-0.5825087401069602
376,IPTV.JK,726,181,0.7790055248618785,205,521,[-0.00129937 -0.00204443 -0.04153449  0.03108463  0.00419007 -0.54313452],-0.9385754345239294
377,IRRA.JK,673,168,0.6607142857142857,266,407,[-0.06036357  0.02268083 -0.07306799 -0.13012063  0.00623859  0.06995247],-0.43180987722364605
378,IRSX.JK,23,5,1.0,9,14,[ 0.01893587 -0.68302958 -0.31698979  0.38209968 -0.31100139  0.041643  ],-0.7205469939631548
379,ISAP.JK,56,13,0.6923076923076923,15,41,[-0.03240244 -0.10493904 -0.08307349  0.58989137  0.3081158   0.4707403 ],-1.0208249470803585
380,ISAT.JK,966,241,0.5435684647302904,391,575,[-0.00022296  0.00930309  0.0108396   0.00448322 -0.00252087  0.07588491],-0.3882118878435739
381,ISSP.JK,967,241,0.6390041493775933,357,610,"[-8.38838137e-02  3.31406688e-02  6.65628548e-04  3.13492889e-03
 -1.00660050e-04 -1.35248692e+00]",-0.5308027272351181
382,ITIC.JK,731,182,0.6043956043956044,282,449,[ 0.24575798 -0.05813951  0.0014381   0.01181561  0.01207747 -0.21318108],-0.4708876577796617
383,ITMA.JK,928,231,0.658008658008658,339,589,"[-9.08764704e-06  6.59701360e-05 -1.71301128e-03  1.15178773e-04
  8.33076812e-04 -1.05277260e-04]",-0.002518013465363225
384,ITMG.JK,967,241,0.49377593360995853,443,524,[ 0.1736883   0.00091205 -0.03418447  0.00749479 -0.00829593  0.39313277],-0.1648540880834215
385,JARR.JK,128,31,0.7741935483870968,36,92,[-0.03154875  0.03883235  0.15715567  0.56395109  0.00506952  0.52140699],-0.9684008687012862
386,JAST.JK,759,189,0.671957671957672,252,507,[ 0.5453225  -0.01540584 -0.05040945  0.13445711 -0.01282474  0.3074595 ],-0.7115924996378892
387,JAWA.JK,967,241,0.6597510373443983,279,688,[-0.13382459 -0.00212756 -0.00798747 -0.02032581  0.00277542 -1.17726768],-0.8977976103442502
388,JAYA.JK,807,201,0.6218905472636815,284,523,[-0.21643348 -0.00145129  0.13513452  0.09787935 -0.01061537 -0.78887804],-0.6073330692824103
389,JECC.JK,831,207,0.7729468599033816,107,724,[-0.35682726 -0.00589583 -0.01671966  0.0106813   0.00737767 -0.03845848],-1.9056193631110208
390,JIHD.JK,968,241,0.6597510373443983,230,738,[-0.1910365  -0.0277532   0.01220608  0.0130759  -0.06266892 -1.65802076],-1.1874342316037845
391,JKON.JK,960,240,0.5875,195,765,[-0.29052113 -0.03104231  0.002342   -0.02329312  0.00848445 -1.14389752],-1.3687006323097826
392,JKSW.JK,192,48,0.8125,58,134,[-0.07610402 -0.01794773 -0.05587949 -0.81918981  0.03234488 -1.4452685 ],-0.8968958147975095
393,JMAS.JK,967,241,0.7178423236514523,256,711,[-0.43012326  0.00375532 -0.00356538  0.07054587  0.01784523 -2.00926115],-1.0201679654316338
394,JPFA.JK,968,241,0.5933609958506224,406,562,[-0.02617166 -0.01068766  0.00665802 -0.00450316  0.00160686 -0.04546021],-0.3219971640225835
395,JRPT.JK,967,241,0.6721991701244814,317,650,"[-3.18517794e-04  2.97722814e-02  3.50440107e-02 -1.67211301e-02
  3.72850412e-02 -9.66220851e-01]",-0.7107775323211365
396,JSKY.JK,831,207,0.7681159420289855,290,541,[ 0.0013839   0.05455256  0.00455259  0.01534481 -0.0009118  -0.00504135],-0.6245461279953619
397,JSMR.JK,967,241,0.6182572614107884,421,546,[-0.08653092 -0.02885428 -0.02639656 -0.01654018  0.01674296  0.1216225 ],-0.265823930682808
398,JSPT.JK,941,235,0.8468085106382979,108,833,[-0.04425246  0.02847855  0.00288788  0.05384005 -0.00178773 -1.71265127],-2.060357700869499
399,JTPE.JK,968,241,0.7344398340248963,296,672,"[ 3.72225159e-01  3.83565693e-04  2.98128350e-03 -2.82093382e-01
  3.46428668e-02  6.87561903e-01]",-0.848988960059173
400,KAEF.JK,967,241,0.6970954356846473,341,626,[ 0.11079389  0.0260403  -0.05062135  0.01211343  0.00468913 -0.0851571 ],-0.6099551542717704
401,KARW.JK,946,236,0.7076271186440678,291,655,[-0.02578095 -0.0020821  -0.01183865 -0.09142709 -0.00169868 -1.22919545],-0.806698416994224
402,KAYU.JK,537,134,0.8582089552238806,158,379,[-0.33770707  0.12353817  0.008237   -0.01824025  0.00605392 -0.40097533],-0.8824954633344748
403,KBAG.JK,294,73,0.9452054794520548,69,225,[ 0.20508475 -0.00966354  0.15279323  0.36391    -0.08907258 -0.26536572],-1.190576354612254
404,KBLI.JK,968,241,0.6597510373443983,326,642,[-0.12114671 -0.00247403  0.01367083 -0.08484315 -0.00122353 -1.12740764],-0.6746322714202992
405,KBLM.JK,967,241,0.6265560165975104,363,604,[-0.31909223  0.01837862 -0.00299643 -0.01375165 -0.02228525 -2.93118756],-0.501281936104891
406,KBLV.JK,965,241,0.6846473029045643,263,702,[-0.20352378 -0.0071409  -0.01092744  0.00298166  0.00184562  0.01438521],-0.9889903205405022
407,KDSI.JK,967,241,0.6348547717842323,364,603,"[-1.43813769e-01 -1.43284983e-03 -6.12502258e-03 -5.98772650e-03
 -3.65283108e-03 -1.52038228e+00]",-0.5023171740197052
408,KDTN.JK,73,18,0.6111111111111112,25,48,[-0.02406973 -0.18650042  1.06202032  0.4503364   0.03516343 -0.28244731],-0.6157360377312195
409,KEEN.JK,698,174,0.6149425287356322,274,424,[-0.0226819  -0.08096727  0.00818481  0.18762686  0.0323199  -1.5705819 ],-0.4361610345594686
410,KEJU.JK,650,162,0.6604938271604939,249,401,[-0.00760413  0.02598168 -0.01292812 -0.10163189 -0.00700047 -1.28195293],-0.4828179748572057
411,KETR.JK,72,18,0.6111111111111112,19,53,[-0.0451057  -0.06623046 -0.08149987 -0.56277114  0.21623657 -0.38217165],-0.9762035022399188
412,KIAS.JK,284,71,0.9154929577464789,66,218,[-0.14038425 -0.2072888   0.06672328  0.33464831  0.01018775 -1.36393495],-1.234266294090618
413,KICI.JK,967,241,0.6265560165975104,281,686,[-0.37885282  0.00714016  0.0074934  -0.00441757  0.00587574  0.15668537],-0.8981428359257498
414,KIJA.JK,967,241,0.8547717842323651,304,663,[-0.09658776 -0.05281975 -0.1102216   0.01774692  0.02481514 -0.52122881],-0.7851389552973354
415,KING.JK,17,4,0.25,10,7,[-0.02157805 -0.11998302 -0.10524329 -0.05886368 -0.62096347  0.01160331],0.4290143180840364
416,KINO.JK,967,241,0.6224066390041494,371,596,[ 0.13278597 -0.01633906 -0.02606226  0.04682977  0.01569925  0.47040735],-0.4780176003463607
417,KIOS.JK,967,241,0.6265560165975104,271,696,[ 0.05639124  0.01996847 -0.01699452  0.01269866 -0.04323516 -0.2534058 ],-0.9439578325244068
418,KJEN.JK,704,175,0.6571428571428571,162,542,[ 0.40162978 -0.00666614  0.04290113  0.09473005 -0.0137547  -0.05896756],-1.2081838993780294
419,KKES.JK,126,31,0.6774193548387096,48,78,[-0.0242365   0.00973714  0.37891725  0.40812604  0.05309052 -0.41085075],-0.4859283149423216
420,KKGI.JK,967,241,0.5767634854771784,387,580,[-0.0730899   0.01133334  0.02555173  0.02523639 -0.00213995 -1.13665782],-0.4040719405523038
421,KLBF.JK,968,241,0.5435684647302904,415,553,"[-1.99828478e-02  3.21466679e-02  1.69796182e-02 -1.93325871e-02
 -4.12205994e-04 -1.24909182e+00]",-0.2785632785291376
422,KLIN.JK,125,31,0.45161290322580644,20,105,[-0.05590589 -0.8352602   0.65361465  0.2756709  -0.26232371 -0.87028197],-1.712290302212962
423,KMDS.JK,499,124,0.6451612903225806,205,294,[-0.07340235  0.02941067  0.14663291 -0.04057431 -0.02785473 -1.89400834],-0.3621131328618236
424,KMTR.JK,966,241,0.6804979253112033,340,626,[-0.06529412  0.00565039 -0.01451515 -0.03593236 -0.00588965 -0.64907083],-0.6028734176457581
425,KOBX.JK,967,241,0.6224066390041494,376,591,[-0.19576207 -0.00679766  0.03057638  0.00547668 -0.00725399 -1.69755897],-0.44390338291573345
426,KOIN.JK,868,217,0.7004608294930875,206,662,[-0.24889893  0.01758996 -0.02910998  0.07898734  0.02548616 -0.55562733],-1.1624145535484156
427,KONI.JK,947,236,0.6822033898305084,231,716,[ 0.54902087 -0.01764805  0.02646902  0.01910504 -0.00298044  0.03627914],-1.1343842642424797
428,KOPI.JK,966,241,0.6887966804979253,259,707,[-0.16868654 -0.00310496 -0.00337079 -0.03620547 -0.00833852 -1.02136446],-1.0013203602448835
429,KOTA.JK,502,125,0.808,180,322,[ 0.35792705 -0.02707903  0.07810163 -0.03126262 -0.02277595  0.53067389],-0.5960250737257291
430,KPAL.JK,528,131,0.9083969465648855,178,350,[ 0.17395679 -0.01096396  0.13007503  0.06046352 -0.01181803 -0.71324475],-0.6670095497546042
431,KPAS.JK,545,136,0.7573529411764706,127,418,[-0.08332633 -0.03072933  0.01455318  0.04754009  0.01167057 -0.1256283 ],-1.1945494296025394
432,KPIG.JK,967,241,0.7219917012448133,274,693,[-0.18461399 -0.08394711  0.03537362 -0.13087531  0.00281868 -0.67273119],-0.9378041837502819
433,KRAH.JK,457,114,0.8596491228070176,121,336,[ 0.31763364  0.02067957  0.06783777 -0.10755338  0.14721085 -0.00579097],-1.0321481424666321
434,KRAS.JK,967,241,0.6680497925311203,362,605,[ 0.01236757  0.05535769  0.01045043 -0.00557435  0.00835072 -0.05809838],-0.5092860446040172
435,KREN.JK,831,207,0.855072463768116,281,550,[ 0.09554614 -0.00742032 -0.02903507  0.00536601  0.00124736  0.55504101],-0.681181627067227
436,KRYA.JK,133,33,0.696969696969697,43,90,[ 0.18198977 -0.54735575 -1.24277849  0.57286465 -0.24038446  0.73232267],-0.8439400124318862
437,KUAS.JK,279,69,0.782608695652174,90,189,[ 0.03179726  0.08008633  0.10839896  0.00953273 -0.07214611 -1.19625331],-0.7704110564070715
438,LABA.JK,352,88,0.6818181818181818,115,237,[ 0.35628981  0.11557624  0.06997235  0.03035418 -0.07195821 -0.4077553 ],-0.7286342374247103
439,LAJU.JK,28,7,0.8571428571428571,11,17,[-0.03351327 -0.04902819  0.7241222   0.4245477  -0.14795548  0.22843763],-0.4076500767848681
440,LAND.JK,828,206,0.7233009708737864,289,539,[-0.2493327   0.02931943  0.16577003 -0.0588846  -0.04999152  0.26115204],-0.6152088148042995
441,LCGP.JK,192,48,0.875,71,121,[-0.03462921 -0.01926702 -0.12981007 -0.06367174 -0.03417558 -1.52651885],-0.5356013850452501
442,LCKM.JK,961,240,0.6875,246,715,"[-3.60129797e-01  9.19146989e-05  1.55763421e-03  1.70714914e-02
  4.33751716e-03 -2.49715887e+00]",-1.0760441085045152
443,LEAD.JK,586,146,0.7123287671232876,142,444,[ 0.01525298  0.02838759 -0.00530055 -0.07486062 -0.00610891 -0.41830214],-1.1425692622391854
444,LFLO.JK,386,96,0.6979166666666666,137,249,[-0.00284743  0.01317109  0.05136604  0.14763197  0.03447388  0.22029997],-0.5792502380627461
445,LIFE.JK,720,179,0.888268156424581,111,609,[-0.00056965  0.04707438  0.03926892 -0.00060503 -0.05236475 -0.26596868],-1.6997382902400857
446,LINK.JK,967,241,0.6348547717842323,390,577,"[-8.81140580e-03 -1.04649260e-04 -1.37682081e-02 -8.80966053e-04
  5.87292598e-03 -2.17711614e-01]",-0.3851041865505029
447,LION.JK,968,241,0.6224066390041494,258,710,[-0.33322748 -0.0515018  -0.01537303  0.05772328 -0.04242875 -1.27855523],-1.0148607422623108
448,LMAS.JK,613,153,0.7973856209150327,144,469,[-0.04612611  0.05182333 -0.01533412 -0.01959509  0.01803372 -2.21867936],-1.1988344268073694
449,LMPI.JK,968,241,0.6721991701244814,318,650,"[-3.43242234e-01  7.22254584e-03  2.27351086e-04 -3.06897318e-02
  1.22223456e-02 -2.56688335e+00]",-0.7166454663481714
450,LMSH.JK,968,241,0.6846473029045643,221,747,"[ 1.88992727e-04  4.74814922e-06 -8.11486024e-03  1.09879493e-02
  6.39317785e-03 -3.08846646e-02]",-1.2173528393520447
451,LPCK.JK,968,241,0.6265560165975104,393,575,[ 0.16786093  0.09111402 -0.01198573 -0.01132154  0.01419983  0.10403872],-0.3736875981179754
452,LPGI.JK,916,229,0.6157205240174672,195,721,"[ 9.58730116e-02 -6.81949883e-05  2.03921856e-02  1.25940997e-02
 -1.78615041e-02 -5.94058328e-01]",-1.3054857485188067
453,LPIN.JK,966,241,0.6473029045643154,306,660,[ 0.09891207  0.10674453 -0.05078724 -0.02260572 -0.01126815 -1.11894919],-0.7692922903275721
454,LPKR.JK,968,241,0.6763485477178424,340,628,[-0.0825874  -0.00990174 -0.00704163  0.01731346 -0.0024965  -0.16657207],-0.6161620469572756
455,LPLI.JK,957,239,0.6317991631799164,298,659,[-0.25463075 -0.01839844 -0.01799341  0.07738341 -0.01482291 -1.51752706],-0.8005024510871459
456,LPPF.JK,967,241,0.5601659751037344,408,559,"[1.70348368e-01 1.67408798e-02 3.80998498e-02 1.04607397e-03
 8.07680077e-05 6.39920674e-01]",-0.32156524938921166
457,LPPS.JK,967,241,0.7095435684647303,308,659,"[-2.18930408e-01  9.53040451e-04 -8.67434923e-03 -5.79989136e-02
  4.32494898e-03 -2.06465045e+00]",-0.75194023239309
458,LRNA.JK,964,241,0.7053941908713693,307,657,"[-2.24811583e-01 -1.43596828e-03  6.55544211e-04 -2.56187306e-02
 -2.19155156e-02 -2.47387491e+00]",-0.7627298974685991
459,LSIP.JK,967,241,0.6307053941908713,414,553,[-0.00521262  0.00741886  0.0066891  -0.02366952  0.00501195 -0.06194244],-0.29286755282342986
460,LTLS.JK,967,241,0.6265560165975104,354,613,[-0.02833114 -0.04632552 -0.07094691 -0.00288569  0.00662366 -0.87729537],-0.5538650748440326
461,LUCK.JK,856,213,0.7183098591549296,302,554,[ 0.26022897  0.01265018 -0.00998325 -0.01817451 -0.01337148 -0.96439647],-0.5984511445982795
462,LUCY.JK,370,92,0.5978260869565217,148,222,[ 0.18321142 -0.01211481 -0.05296186 -0.00105641 -0.03897191  0.65787795],-0.4322215755118089
463,MABA.JK,232,57,0.9473684210526315,50,182,[-0.02689777 -0.07615929  0.1832      0.34021629  0.00194108  0.0593063 ],-1.2954361506703387
464,MAIN.JK,966,241,0.6680497925311203,391,575,[-0.02806587  0.05536935 -0.01318613 -0.04178415 -0.00431467 -0.68585983],-0.38020727957332257
465,MAMI.JK,324,80,0.575,132,192,[ 0.13119791  0.05099347  0.12005974 -0.2413446   0.02514219  0.54494117],-0.37821749393197074
466,MAPA.JK,939,234,0.5384615384615384,319,620,[ 0.00064628  0.02273434  0.00243818  0.00079448  0.00150291 -0.00509214],-0.6680728799903066
467,MAPB.JK,967,241,0.6182572614107884,264,703,"[-6.26883137e-02 -1.90357883e-02  1.40274878e-04 -8.20689614e-04
 -1.75988836e-03 -1.90008340e+00]",-0.980384744894715
468,MAPI.JK,967,241,0.5269709543568465,382,585,[-0.1697161   0.0356302   0.00487177 -0.01765129 -0.00365219 -0.076298  ],-0.43228384997582026
469,MARI.JK,910,227,0.6343612334801763,320,590,"[ 3.71430488e-01  6.29253912e-02  2.18420029e-02 -6.23117826e-03
 -3.17215287e-04 -6.52456441e-01]",-0.6179796407388762
470,MARK.JK,967,241,0.6182572614107884,392,575,[ 0.00618354  0.00192324  0.00531843 -0.04019409  0.00816707 -0.18672119],-0.3829077052934424
471,MASA.JK,924,231,0.6320346320346321,308,616,[-0.00646483 -0.00458287  0.00078289  0.03730989  0.00834795  0.08817556],-0.6957640602190858
472,MASB.JK,341,85,0.7176470588235294,92,249,[-0.02391507 -0.01470985 -0.03827672 -0.07812225  0.06414633 -2.29428903],-1.0151540575941862
473,MAYA.JK,923,230,0.6652173913043479,176,747,[ 0.33009469  0.02493983  0.0478807   0.06788429  0.08045763 -0.11652035],-1.4559258162832656
474,MBAP.JK,967,241,0.5684647302904564,417,550,[ 0.0169929  -0.00382967  0.00246286 -0.00424574 -0.00297767  0.06245972],-0.27487111004225506
475,MBSS.JK,967,241,0.6348547717842323,363,604,[-0.11304686  0.01449461  0.0425071  -0.00732256 -0.03758543 -0.27559473],-0.5122080407171575
476,MBTO.JK,966,241,0.6265560165975104,349,617,"[-5.50342434e-01  4.31285054e-03  4.43236692e-02  4.50108759e-02
  1.43682108e-03 -2.60820371e+00]",-0.5673444253047827
477,MCAS.JK,966,241,0.6141078838174274,413,553,[ 0.49651347  0.0044285  -0.01080799  0.00471309 -0.02585127  1.53686518],-0.3047578637937665
478,MCOL.JK,305,76,0.5789473684210527,141,164,[ 0.02649308 -0.01153012 -0.00063956  0.0873435   0.00570074 -0.42889368],-0.14258648187939504
479,MCOR.JK,967,241,0.7219917012448133,307,660,[-0.12427252  0.01694089  0.0199645   0.01439181  0.00371108  0.20765378],-0.7650488544188527
480,MDIA.JK,656,164,0.8902439024390244,192,464,[-0.24499139  0.06008897 -0.00905405  0.07157853  0.00460406 -1.17531272],-0.8849711125514993
481,MDKA.JK,968,241,0.6058091286307054,432,536,[-0.18240362  0.09469546 -0.00646095 -0.00126363 -0.00552481 -0.4766015 ],-0.21828616408721313
482,MDKI.JK,965,241,0.6514522821576764,345,620,[-0.08679499  0.02823548  0.03372024  0.04550561 -0.00354204 -2.3735012 ],-0.586325932602914
483,MDLN.JK,748,186,0.6827956989247311,225,523,[ 0.24345092 -0.03116435 -0.03938896  0.02061226 -0.00628305 -0.94803048],-0.8386839560222755
484,MEDC.JK,968,241,0.5269709543568465,377,591,[ 0.06038524 -0.03263589  0.07976698  0.02153898  0.03376907 -0.82456561],-0.44586743335589757
485,MEDS.JK,124,31,0.6774193548387096,47,77,[-0.02778887 -0.18988418  0.22612189 -0.40857139  0.18943809  0.54035642],-0.43726735024143587
486,MEGA.JK,953,238,0.6218487394957983,230,723,[-0.20969488  0.03768826 -0.03065822 -0.00156703  0.00220795  0.00106428],-1.1541756782568016
487,MERK.JK,967,241,0.5518672199170125,339,628,[ 0.04410844  0.00549992 -0.03185396 -0.03694758  0.01522002 -0.32902316],-0.6162723138917344
488,META.JK,966,241,0.6556016597510373,321,645,"[ 9.16481896e-02 -2.32508512e-02  1.17234629e-01  1.86147278e-02
 -1.05278960e-04 -7.97184861e-01]",-0.6954222696142822
489,MFIN.JK,967,241,0.6390041493775933,294,673,[-0.02675894 -0.00911894  0.04078072 -0.01885684 -0.0187671  -2.28646535],-0.830774610805748
490,MFMI.JK,967,241,0.6348547717842323,322,645,[-0.09819857  0.03032491  0.01117369  0.03372604  0.00431543 -1.53789643],-0.6918350041083526
491,MGLV.JK,353,88,0.7727272727272727,142,211,[-0.04229057  0.12429975 -0.01727109 -0.03529804  0.00172861  0.79304545],-0.4043017304427343
492,MGNA.JK,87,21,1.0,7,80,[-0.00191094 -0.16150903 -0.04988434  0.02338344 -0.32693662 -0.00093752],-2.4083784025763917
493,MGRO.JK,935,233,0.592274678111588,330,605,[ 0.20080169  0.11791711 -0.0286728  -0.00966725  0.00931128  1.2154072 ],-0.6150006184073168
494,MICE.JK,967,241,0.5726141078838174,335,632,"[-1.47024474e-01 -5.05833849e-04  6.02023797e-02 -1.63937958e-02
  1.81103764e-02 -1.85725045e+00]",-0.6319271110474575
495,MIDI.JK,944,235,0.6042553191489362,186,758,"[-3.74816667e-02  2.02665267e-03  4.39675810e-03 -8.54629527e-02
  4.53670662e-04 -9.36725846e-01]",-1.4022927625839858
496,MIKA.JK,967,241,0.5767634854771784,436,531,[-0.0624038  -0.00348795 -0.01255719 -0.01148983  0.01386007 -0.70842997],-0.19589343197715692
497,MINA.JK,645,161,0.7888198757763976,194,451,[ 0.57262781 -0.08365605  0.01060592 -0.01356609  0.00270857 -0.10449469],-0.8418350384208394
498,MITI.JK,546,136,0.5882352941176471,134,412,[-0.09409758  0.02406461 -0.11439833  0.05003456  0.01925918 -0.51168445],-1.123328281626367
499,MKNT.JK,303,75,0.8933333333333333,97,206,[-0.09778333  0.09589725  0.1202672  -0.04269501 -0.01007664 -1.46880739],-0.7494127854967534
500,MKPI.JK,826,206,0.6456310679611651,86,740,"[ 5.56988246e-12 -6.04688554e-11  6.22322219e-10 -1.29390176e-09
 -1.58302779e-08 -4.73136373e-07]",-2.2322351064875146e-08
501,MKTR.JK,74,18,0.6111111111111112,30,44,[-0.00154669  0.04008237  0.02594034  0.222614   -0.00497009  0.08955827],-0.401911949773013
502,MLBI.JK,967,241,0.6307053941908713,280,687,[ 0.09712031 -0.0059302   0.00796897  0.05544844  0.04141655 -0.2822936 ],-0.8945102558234214
503,MLIA.JK,968,241,0.6390041493775933,391,577,[ 0.00783192  0.00121547  0.00348095 -0.09336656  0.00586284  0.53883161],-0.3964306458351443
504,MLPL.JK,967,241,0.6431535269709544,291,676,[ 0.08133933 -0.01446437  0.03234666 -0.02700713 -0.00787672 -0.68753717],-0.8378968858856835
505,MLPT.JK,960,239,0.6192468619246861,314,646,[ 0.11846051 -0.03005862 -0.01253589 -0.00213765 -0.00627821 -0.09802283],-0.7252645202479026
506,MMIX.JK,58,14,0.42857142857142855,23,35,[ 0.07332452 -0.73716775  0.23503249  0.21969078 -0.05487971  0.13542194],-0.40391570216176975
507,MMLP.JK,966,241,0.6182572614107884,342,624,[-0.2154937  -0.00396774 -0.01623941  0.03224096 -0.00384302 -1.29965703],-0.5988332926860412
508,MNCN.JK,967,241,0.6473029045643154,359,608,"[ 5.96387734e-03 -7.88848346e-05 -1.56755074e-03  2.54170137e-02
  6.16788425e-03 -5.54664509e-01]",-0.5193525564586571
509,MOLI.JK,907,226,0.6194690265486725,260,647,[-0.35739521  0.01508908 -0.05261226 -0.03189192  0.00231672 -0.91343554],-0.9045481798797123
510,MORA.JK,126,31,0.6774193548387096,39,87,[-0.02164757  0.08747157 -0.07017749  0.34806956 -0.00725705  0.43254839],-0.735314800587554
511,MPMX.JK,947,236,0.6313559322033898,363,584,[-0.01056887 -0.02393205 -0.00526981  0.07916301  0.00024418 -0.12485204],-0.4810344696616879
512,MPOW.JK,967,241,0.6846473029045643,334,633,[-0.10721872  0.03557662  0.10179018 -0.00709741  0.00274853 -1.21199469],-0.6411423996292317
513,MPPA.JK,968,241,0.6473029045643154,343,625,[ 0.17931022  0.02076602  0.03965627 -0.00239447  0.0124872   0.51485159],-0.6050733309580152
514,MPRO.JK,883,220,0.7272727272727273,233,650,[-0.14289207  0.04416359 -0.00278173  0.08830863  0.04649185  0.04773184],-1.0257775050676392
515,MRAT.JK,967,241,0.6058091286307054,333,634,[-0.24053117  0.00988984 -0.01134615 -0.01541287  0.0161517  -1.73851483],-0.6418450701718765
516,MREI.JK,944,236,0.6271186440677966,208,736,[-0.53221133 -0.00777408 -0.02948195  0.01640989  0.00415632 -0.67495867],-1.2590463100275662
517,MSIN.JK,954,238,0.6974789915966386,344,610,[ 0.65735938  0.01078565  0.0386818  -0.08580697  0.00379919 -0.05561587],-0.5796758480895057
518,MSKY.JK,966,241,0.6639004149377593,275,691,"[-2.20422990e-01 -6.93997086e-02  8.61573594e-03  7.91491680e-02
  2.54732256e-04 -1.39518651e+00]",-0.9259299403874126
519,MTDL.JK,968,241,0.6597510373443983,411,557,[-0.18485521 -0.02140618  0.02517158  0.00154166  0.00771541 -0.04537581],-0.3047481693404873
520,MTEL.JK,263,65,0.676923076923077,93,170,[-0.01133967  0.0398105  -0.01062792  0.17899229  0.14492588  0.03968789],-0.5983516861176654
521,MTLA.JK,967,241,0.6265560165975104,291,676,"[-1.21936875e-07  1.03829476e-05  3.70823776e-05  1.42324989e-05
 -6.32169141e-05 -4.18637253e-06]",-8.496965456600042e-05
522,MTMH.JK,181,45,0.6222222222222222,54,127,[ 0.01082682 -0.02874167 -0.28702502 -0.16481074  0.0124601   0.40367556],-0.8807107229676434
523,MTPS.JK,748,186,0.8387096774193549,235,513,[ 0.38439294  0.014272   -0.02048285  0.19044705  0.01462084  0.11456376],-0.7922501616665582
524,MTRA.JK,352,87,0.8045977011494253,95,257,[ 0.01248629  0.2008321  -0.11837727  0.01943137 -0.00075009 -0.0321049 ],-1.005369438932138
525,MTSM.JK,966,241,0.6348547717842323,260,706,[-0.37162732  0.00944656 -0.02271964  0.0015143   0.02188034 -0.74038195],-0.9996037662760247
526,MTWI.JK,966,241,0.6639004149377593,325,641,[-0.0148507  -0.02484886 -0.02080927  0.01572654 -0.00575776 -1.39819094],-0.6797232656627192
527,MYOH.JK,967,241,0.7427385892116183,355,612,[-0.11210407 -0.00779534  0.01048356 -0.02389518  0.02488307 -0.95817378],-0.5438596706066992
528,MYOR.JK,968,241,0.5518672199170125,343,625,"[-6.90585469e-02 -2.25762637e-02  6.84611410e-03 -2.26040139e-02
 -2.19095209e-04  5.04592833e-01]",-0.60575959174862
529,MYRX.JK,308,77,0.8441558441558441,92,216,[-0.04233876 -0.05898809 -0.14499668  0.38605064 -0.01363334 -1.64313178],-0.8675443644601316
530,MYTX.JK,964,241,0.6763485477178424,276,688,"[-3.60358114e-01  9.63484595e-02 -3.46426715e-03 -8.88258021e-02
 -9.50089849e-04 -2.87377663e+00]",-0.9307829281613811
531,NANO.JK,204,50,0.76,47,157,[ 0.00934891  0.20811805 -0.02139966  0.56398507  0.13847545 -0.10669154],-1.2188056143266903
532,NASA.JK,577,144,0.75,132,445,[ 0.1551518   0.01414607 -0.08093855  0.00470909  0.01682166  0.27012231],-1.2252626633729349
533,NASI.JK,251,62,0.7741935483870968,93,158,[-0.0774762   0.05564084 -0.08680579 -0.27192958  0.01683809  0.55259037],-0.5333226789223718
534,NATO.JK,826,206,0.6213592233009708,306,520,"[ 5.61574941e-02  1.71645177e-02  1.19696798e-03  1.02839723e-02
 -5.85093569e-03  1.47503065e+00]",-0.5521150467896151
535,NAYZ.JK,24,5,0.2,14,10,[-0.02665071  0.35279049  0.4585425  -0.38173258  0.20209328  0.06137811],0.31274042644056527
536,NELY.JK,967,241,0.6680497925311203,336,631,[-0.18921888  0.00848774  0.01823751  0.05320091 -0.00195252 -1.48142919],-0.628554799101066
537,NETV.JK,226,56,0.6785714285714286,72,154,[-0.05731653 -0.01659728  0.53704363  0.01985592 -0.00613682 -1.06471654],-0.7492879574702546
538,NFCX.JK,935,233,0.6566523605150214,349,586,"[ 7.51805601e-01  5.22844836e-02  8.76592618e-03  2.91217868e-02
 -5.85771398e-04  9.01286247e-01]",-0.5246766260535093
539,NICK.JK,967,241,0.5435684647302904,313,654,"[-1.29437033e-01 -1.70440219e-03  2.01502047e-03  1.53895646e-04
 -3.22362845e-03 -1.83732673e+00]",-0.7291532252592722
540,NICL.JK,336,84,0.5833333333333334,112,224,[ 0.07183456  0.00968074  0.11226115  0.00269421 -0.0714792  -1.25078819],-0.6977591753079507
541,NIKL.JK,967,241,0.6763485477178424,356,611,[ 0.17135054 -0.00753658 -0.23986635  0.00653573 -0.00894761  0.07990555],-0.5410560419009856
542,NINE.JK,59,14,0.7142857142857143,10,49,[-0.00254547  0.02840309  0.34309471 -0.25436807 -0.08085903  0.87666342],-1.6479570834150505
543,NIRO.JK,966,241,0.7178423236514523,238,728,"[-2.28143125e-01  1.23625003e-02 -4.04348405e-04 -1.67700137e-02
  6.19393044e-04 -2.54074693e+00]",-1.125346584717311
544,NISP.JK,967,241,0.6099585062240664,308,659,"[-2.43204917e-02 -9.20720754e-02 -2.95554562e-02 -1.85865780e-02
  2.31468946e-04 -1.62546122e+00]",-0.7646611292005665
545,NOBU.JK,940,235,0.6595744680851063,240,700,[-0.28271223  0.03076859 -0.00838541  0.04403973  0.00161352 -0.07474172],-1.0704034752052434
546,NPGF.JK,356,89,0.8651685393258427,107,249,[ 0.00570396  0.0807152  -0.00877621 -0.12696269  0.037048    0.30222991],-0.8735076948668468
547,NRCA.JK,967,241,0.6016597510373444,366,601,[-0.08857391 -0.00249316  0.02757935 -0.01045642  0.01458539 -1.14164871],-0.48426283860171465
548,NSSS.JK,4,1,0.0,3,1,[-0.0005791  -0.15235476  0.08875506  0.03975315  0.01766473 -0.02236441],1.1292591322961472
549,NTBK.JK,109,27,1.0,9,100,[-0.03849685  0.26069772 -0.14313817  0.06331727  0.03216801 -0.12150206],-2.4324015478926544
550,NUSA.JK,267,66,0.803030303030303,85,182,[ 0.33276511  0.22137517  0.65253756  0.37399987 -0.0045285   0.09767624],-0.7809668810797511
551,NZIA.JK,683,170,0.6294117647058823,239,444,"[-7.45349102e-03 -9.74046445e-05  1.24238907e-02  3.69331974e-02
 -9.79542533e-03 -6.51816308e-01]",-0.6158857088836227
552,OASA.JK,967,241,0.5809128630705395,262,705,[ 0.12205382  0.007173    0.00313614  0.10037948 -0.00902459 -0.97081495],-0.9851664189477317
553,OBMD.JK,253,63,0.5396825396825397,95,158,[ 0.21514407 -0.08607103  0.49630892 -0.08401696 -0.11531683 -0.1523739 ],-0.5551815179357213
554,OCAP.JK,324,81,0.9259259259259259,76,248,[-0.55796474  0.02306284  0.02428754  0.09021769 -0.07512774 -0.1547811 ],-1.162445446723985
555,OILS.JK,306,76,0.6447368421052632,100,206,[-0.08770915 -0.01674048 -0.1494274  -0.12292846 -0.01163294 -0.37046015],-0.7422422408978313
556,OKAS.JK,966,241,0.6556016597510373,320,646,[-0.20061281 -0.0328822   0.04711154 -0.03655206 -0.00463383 -0.21914023],-0.7169692715898015
557,OLIV.JK,172,42,0.7857142857142857,40,132,[-0.09073961 -0.04275259  0.13397797 -0.17771271 -0.05776082  0.58417106],-1.2382271745246909
558,OMED.JK,74,18,0.6111111111111112,27,47,[-0.01088888  0.13250753  0.4250505   0.43829677  0.12759778  0.08704152],-0.5561944765776371
559,OMRE.JK,688,172,0.6686046511627907,149,539,[ 0.014334    0.00338225 -0.02044033 -0.00890864  0.00451774 -0.01866157],-1.2857355701554467
560,OPMS.JK,685,171,0.7426900584795322,257,428,[ 0.16920402 -0.12045301  0.11212068  0.10295017 -0.01202865  0.3932667 ],-0.5329036710742585
561,PACK.JK,22,5,0.6,11,11,[-0.01804565 -0.46014028 -0.12781669 -0.17844532 -0.11238215 -0.12189084],0.07429657267976407
562,PADA.JK,56,14,0.35714285714285715,18,38,[-0.0391314   0.4805094  -0.42700824  0.05653096 -0.15121909  0.34269842],-0.7874010892711787
563,PADI.JK,366,91,0.8791208791208791,119,247,[-0.05840659 -0.00832893  0.03401888 -0.1125186  -0.01048928 -0.35104383],-0.7256212567949771
564,PALM.JK,968,241,0.6431535269709544,348,620,[-0.17982571  0.00687273 -0.00663066  0.04801192 -0.01027344 -1.46758203],-0.5706695425152558
565,PAMG.JK,731,182,0.7252747252747253,248,483,[ 0.0454215   0.00172321 -0.00133022  0.0295184   0.01500283 -0.75271593],-0.6619825902212926
566,PANI.JK,896,223,0.6053811659192825,319,577,"[ 2.94631857e-02  5.24623310e-03 -7.47633932e-03 -7.69793598e-03
  8.22701545e-04 -1.63188060e+00]",-0.5916836903076323
567,PANR.JK,967,241,0.5726141078838174,358,609,[ 0.35430211  0.00302576  0.02653388  0.13173352  0.00056038 -0.21234475],-0.5350129629254606
568,PANS.JK,967,241,0.5560165975103735,372,595,"[ 2.24566568e-03  5.67417322e-02  8.67476438e-02 -9.80824583e-02
 -3.36087281e-04 -1.22137599e+00]",-0.4617271794658845
569,PBID.JK,967,241,0.6099585062240664,385,582,[-0.01799999 -0.05619485 -0.02056797 -0.03090616 -0.03145251 -2.1654927 ],-0.41396888606514
570,PBRX.JK,967,241,0.7012448132780082,316,651,[-0.0029276  -0.00740888 -0.00903524  0.0405831  -0.00401055 -0.07254628],-0.7174955668731757
571,PBSA.JK,929,232,0.6120689655172413,265,664,[-0.13672619 -0.03812211 -0.03963461 -0.07671705 -0.0038833  -0.05752039],-0.9238278025991746
572,PCAR.JK,956,239,0.7656903765690377,272,684,[-0.0456213   0.0394147   0.01863707  0.04169993 -0.01643713 -0.03508636],-0.9208972580858831
573,PDES.JK,861,215,0.772093023255814,198,663,[-0.13220991  0.00118657 -0.10171342 -0.01663986  0.00862283  0.00016299],-1.2276771678576914
574,PDPP.JK,73,18,0.4444444444444444,30,43,[-0.04352296  0.13136231 -0.22781819  0.04853999  0.02671951 -0.03786015],-0.4459913752446888
575,PEGE.JK,967,241,0.6556016597510373,293,674,[ 0.37769347 -0.01694208 -0.00369487 -0.04149548  0.05215269 -0.87559146],-0.8265735612787225
576,PEHA.JK,839,209,0.7129186602870813,298,541,[-0.14202681 -0.01533096  0.02433076  0.01079872 -0.00510488 -1.11873579],-0.5985696706087432
577,PEVE.JK,31,7,0.42857142857142855,11,20,[-0.02470279 -0.23088462  1.03099204  0.18645892  0.05500259 -0.30393243],-0.5420551640732438
578,PGAS.JK,967,241,0.5726141078838174,425,542,[-0.05297007  0.05493182 -0.01439137  0.04155673 -0.0053895  -0.36444606],-0.24070265616154968
579,PGEO.JK,12,3,0.6666666666666666,6,6,[-0.00341723 -0.36981317  0.13220732 -0.0233427  -0.1121293  -0.1748414 ],-0.060487655359256605
580,PGJO.JK,621,155,0.7096774193548387,211,410,[ 0.26621437  0.01498779  0.24936685  0.02178541 -0.00195586 -0.36042004],-0.6775457204813495
581,PGLI.JK,962,240,0.6416666666666667,275,687,"[-1.99656269e-01  6.81759102e-04 -3.44147586e-03 -2.64497528e-02
  9.65969166e-04 -1.58847871e+00]",-0.9146024049598098
582,PGUN.JK,530,132,0.6439393939393939,169,361,[-0.13322287 -0.00380382 -0.06028394  0.00251554  0.02423946 -1.0582295 ],-0.7514123681771954
583,PICO.JK,967,241,0.6307053941908713,317,650,"[-2.39724250e-02  2.20351614e-04 -2.21089125e-02 -2.62426324e-02
 -6.72222582e-03 -1.77247936e+00]",-0.718102465422809
584,PJAA.JK,966,241,0.6680497925311203,285,681,[-0.06543001  0.0013043  -0.02770838  0.00561776  0.01329587 -0.04320869],-0.8672903671186719
585,PKPK.JK,904,226,0.5309734513274337,254,650,[-0.03775579  0.00127195 -0.01192452 -0.01053577  0.00677162 -1.25402852],-0.9448418863775527
586,PLAN.JK,493,123,0.7967479674796748,137,356,"[-4.78525528e-04  3.30289057e-02  4.16719914e-02 -3.50342798e-03
 -6.44287424e-03 -6.22761947e-01]",-0.9644643662029245
587,PLIN.JK,796,199,0.678391959798995,151,645,[-0.30576931  0.0083688  -0.00402642  0.06116578  0.0263064   0.18668984],-1.4705984075383884
588,PMJS.JK,636,159,0.6352201257861635,223,413,"[-1.27582671e-01 -1.09348972e-03  1.58673025e-02 -1.75573075e-03
  5.48296620e-03 -1.94529380e+00]",-0.6176025591680587
589,PMMP.JK,443,110,0.7272727272727273,184,259,"[-9.05303008e-02 -3.33010122e-02 -1.51193495e-02 -8.81134808e-02
 -5.90193329e-04 -1.09595142e+00]",-0.3464985770046673
590,PNBN.JK,967,241,0.5726141078838174,369,598,[-0.05443925 -0.01769496 -0.01384249  0.01214602  0.00189872 -0.08348418],-0.48786240208281456
591,PNBS.JK,775,193,0.6683937823834197,234,541,[-0.03054314  0.13473623  0.09806564 -0.16302393  0.00367118 -0.84048115],-0.8454347325540698
592,PNGO.JK,502,125,0.672,167,335,"[-1.46697547e-01 -5.08989538e-02 -9.43355330e-03 -1.50806482e-04
 -1.16886535e-02 -1.87759511e+00]",-0.699326238224244
593,PNIN.JK,966,241,0.5850622406639004,355,611,[-0.09435905  0.05628578  0.03007155 -0.04163046 -0.00744582 -2.06006195],-0.5475509184910985
594,PNLF.JK,968,241,0.5892116182572614,354,614,[-0.01008206  0.00572673  0.00469472  0.02500832 -0.00655641 -0.26389474],-0.5478663471815179
595,PNSE.JK,908,226,0.8407079646017699,146,762,[ 0.05582623 -0.02315188  0.1260037   0.0541955  -0.01341182 -0.02172393],-1.6692354498854454
596,POLA.JK,862,215,0.7209302325581395,237,625,[-0.00363556  0.08574768  0.00455845 -0.00271011 -0.00565468 -1.15181419],-0.967928209372681
597,POLI.JK,831,207,0.642512077294686,310,521,[-0.04730876  0.03411008  0.12509945 -0.07686855 -0.00969906 -1.92467409],-0.5297053618225755
598,POLL.JK,936,233,0.721030042918455,319,617,[ 0.62262829 -0.01294098  0.01508778 -0.01159907  0.02740197  0.43869843],-0.6660636975681989
599,POLU.JK,736,184,0.6467391304347826,213,523,"[-2.98209950e-01  1.88580025e-02  1.33930517e-04 -1.05444961e-01
 -8.23962413e-03  6.28469340e-02]",-0.917765090936824
600,POLY.JK,864,216,0.7314814814814815,244,620,[-0.1007864  -0.01047852 -0.00903294  0.03107294  0.00578761 -1.71460834],-0.9350886099275525
601,POOL.JK,349,87,0.8620689655172413,138,211,[-0.09191754  0.00306    -0.01292656  0.20144783  0.00893604 -0.04138917],-0.42566052820192246
602,PORT.JK,904,225,0.68,188,716,"[-5.05351224e-01 -1.83226850e-02 -2.81210290e-04 -4.16385393e-03
  1.85007072e-02 -6.62863289e-01]",-1.3360829009681472
603,POSA.JK,95,23,1.0,15,80,[ 0.12027785 -0.07990627  0.54389759  0.37509642 -0.53640795  0.57923641],-1.8134660151586552
604,POWR.JK,967,241,0.6680497925311203,292,675,[-0.00573938 -0.00330663  0.02878954  0.05861837 -0.00437756 -1.15735013],-0.8339477843008984
605,PPGL.JK,524,130,0.5846153846153846,184,340,[ 0.12191808  0.00933626 -0.00373339 -0.06477551  0.06941194  0.23685795],-0.6264589339827534
606,PPRE.JK,967,241,0.6721991701244814,341,626,[-0.00615125  0.01336944  0.07134408 -0.03561259  0.00023134 -0.10399509],-0.608298749982615
607,PPRO.JK,832,208,0.8317307692307693,231,601,[ 0.00299871  0.1555512  -0.01061352  0.0804732   0.00437046 -0.02120879],-0.9494679336573728
608,PRAS.JK,966,241,0.7136929460580913,270,696,[-0.12933002  0.00850101 -0.00475131 -0.01552638  0.00487107 -1.39357332],-0.9406718624727354
609,PRAY.JK,74,18,0.8333333333333334,28,46,[ 0.0014489  -0.00382898 -0.00507942 -0.06352398 -0.11533954 -0.36430927],-0.5304987757379748
610,PRDA.JK,967,241,0.6099585062240664,351,616,"[-5.96693025e-04  3.85622433e-06 -3.59344424e-03  2.35238708e-02
  1.01805057e-02 -3.53295958e-02]",-0.5698364432118567
611,PRIM.JK,967,241,0.7219917012448133,303,664,[-0.00846495 -0.02118077  0.00294246 -0.00336784 -0.00500806 -0.66532046],-0.7800384905819755
612,PSAB.JK,966,241,0.6141078838174274,349,617,[-0.03069917  0.01018279  0.19565879 -0.00144746 -0.00601941 -0.22461499],-0.5776470330327448
613,PSDN.JK,967,241,0.6473029045643154,310,657,[-0.26073642  0.01262577 -0.00252006 -0.04581879 -0.00824417 -1.10477213],-0.7499803508458159
614,PSGO.JK,650,162,0.6234567901234568,251,399,[-0.11289936  0.00635505  0.01347333 -0.02982593 -0.00753088 -0.7637231 ],-0.4693004945522071
615,PSKT.JK,264,66,0.7424242424242424,87,177,[-0.05314237  0.01099395  0.01932166  0.70863092  0.01213355 -1.08511737],-0.7310888623661226
616,PSSI.JK,967,241,0.6099585062240664,398,569,[-0.02573683 -0.00746325  0.03058026 -0.00125397  0.01333534 -0.54286943],-0.34434708569589134
617,PTBA.JK,967,241,0.5518672199170125,425,542,[ 0.00802659 -0.01577619 -0.03475128 -0.17488209  0.00699284 -0.55921727],-0.23993656666928412
618,PTDU.JK,420,104,0.7980769230769231,134,286,[ 0.48499819  0.31278928  0.05244264 -0.02810885  0.00932125  0.54019944],-0.7781216276709381
619,PTIS.JK,955,238,0.6512605042016807,211,744,[-0.01037942 -0.01251311 -0.0116124   0.05759587  0.00487452 -0.95750986],-1.2603920781040152
620,PTMP.JK,8,1,1.0,2,6,[-0.00445273  0.26258598 -0.13613869 -0.03129623 -0.52008959 -0.0954652 ],-1.76268821370186
621,PTPP.JK,967,241,0.6099585062240664,385,582,[ 0.01675531 -0.00301696 -0.07240448  0.08125276  0.01106461  0.30971575],-0.4160964425297477
622,PTPW.JK,610,152,0.6447368421052632,227,383,[ 0.18324797 -0.02891666  0.01309006 -0.21235366  0.01915438  0.67329392],-0.5424551068157742
623,PTRO.JK,967,241,0.5228215767634855,417,550,[-0.10212203  0.00300859 -0.00114663 -0.03238372 -0.00987731 -0.35629258],-0.27240099393977923
624,PTSN.JK,968,241,0.6514522821576764,341,627,"[-1.16726024e-02  6.38806915e-05 -1.00616895e-02 -4.34949037e-03
 -7.10800063e-03 -9.53652844e-01]",-0.6038769471398654
625,PTSP.JK,775,193,0.8341968911917098,144,631,[ 0.10372188  0.05902356  0.0073327   0.15311669 -0.02180112 -0.0070888 ],-1.4880938712108518
626,PUDP.JK,961,240,0.65,204,757,"[-1.18800572e-01 -1.91768764e-02 -4.26490294e-03  1.70011612e-02
 -1.20493972e-03 -1.25869265e+00]",-1.3097991748367046
627,PURA.JK,404,100,0.87,150,254,[ 0.19969224 -0.06016235 -0.0348179   0.15552366 -0.00743278 -0.45324894],-0.550302351074257
628,PURE.JK,538,134,0.8283582089552238,167,371,[-0.09098787 -0.08868009 -0.04354542 -0.05314049  0.00234705 -0.40812147],-0.8042442064235958
629,PURI.JK,498,124,0.6532258064516129,165,333,"[-3.09871038e-01 -2.32884038e-02  2.95234644e-02  2.69440965e-01
  1.54216464e-03 -1.74403114e+00]",-0.7112156896098837
630,PWON.JK,966,241,0.5975103734439834,382,584,[-0.03370182 -0.00467229 -0.0412003   0.0314912   0.01393295 -0.12740721],-0.43041753715465475
631,PYFA.JK,966,241,0.6763485477178424,287,679,"[ 2.17242711e-01  1.81406242e-02  4.92548461e-04  5.45743067e-02
  2.78172696e-03 -1.56581685e+00]",-0.8589675941572515
632,PZZA.JK,964,240,0.7541666666666667,348,616,[-0.05416629  0.0657568  -0.04696094 -0.02014015  0.00211119 -0.69575816],-0.5647391954216328
633,RAFI.JK,127,31,0.7741935483870968,44,83,[-0.04290709 -0.50102388  0.22475989 -0.43352562  0.01990235 -0.30307   ],-0.670468951856411
634,RAJA.JK,967,241,0.5435684647302904,334,633,[ 0.0037689   0.0189658   0.00690072  0.03803062  0.00185145 -0.18005965],-0.6419298144438872
635,RALS.JK,968,241,0.6556016597510373,371,597,"[-3.95758062e-03 -5.49785827e-05 -7.23568997e-03 -1.05343501e-02
  4.13084970e-03  1.26067629e-01]",-0.4788819534305853
636,RANC.JK,967,241,0.6721991701244814,305,662,[ 0.05969711  0.0176847  -0.05801928  0.1005985  -0.01486372 -0.34099645],-0.7728910296583132
637,RBMS.JK,770,192,0.7447916666666666,193,577,[-0.08135521  0.03935572  0.01671746 -0.01588352 -0.00495836 -0.40307183],-1.1107354098533817
638,RCCC.JK,129,32,0.4375,50,79,[-0.00419123 -0.08061626 -0.00571083 -0.04151518  0.00597106 -0.15732506],-0.4343600539682985
639,RDTX.JK,967,241,0.7261410788381742,170,797,[-0.10872684  0.03038626 -0.00843813 -0.02828426  0.00416984 -0.75040079],-1.546693187292096
640,REAL.JK,284,70,0.7857142857142857,75,209,[-0.11347163 -0.06576643 -0.12733108  0.26700103 -0.01384582 -0.41614042],-1.061857527828413
641,RELI.JK,965,241,0.7178423236514523,186,779,[-0.48278943  0.0051404   0.02519111 -0.02189344 -0.00323024 -0.5917447 ],-1.4289115853469405
642,RICY.JK,966,241,0.6473029045643154,313,653,"[-7.13694513e-02  6.18241758e-03 -1.99303189e-02 -9.87391266e-02
  7.58751796e-04 -2.34015110e+00]",-0.7326642026727165
643,RIGS.JK,966,241,0.6390041493775933,353,613,[-0.01202873 -0.00917967 -0.01916238 -0.06544034 -0.01678637 -1.14862109],-0.5487862077695796
644,RIMO.JK,309,77,0.7792207792207793,114,195,[-0.01160925 -0.02413736  0.00495622 -0.06645491 -0.01717881 -1.03942897],-0.5441177272306612
645,RISE.JK,937,234,0.7051282051282052,316,621,[ 0.1954264  -0.01373449  0.06483679 -0.02698583  0.00283808  0.75995075],-0.6802338134007868
646,RMBA.JK,639,159,0.710691823899371,194,445,"[ 1.49042580e-01 -4.20548115e-04  3.75494566e-02  1.39714214e-02
 -4.43190435e-03 -1.69191441e+00]",-0.828044955435646
647,RMKE.JK,254,63,0.5873015873015873,108,146,[-0.09567456  0.02749454  0.6252837  -0.08492267 -0.04300797  0.54212612],-0.32102215753602537
648,ROCK.JK,496,124,0.717741935483871,157,339,"[-3.36389004e-01 -1.08068883e-04 -1.04373511e-01 -1.60748377e-02
 -2.64596275e-03 -1.66712854e+00]",-0.762322394152513
649,RODA.JK,956,238,0.7478991596638656,273,683,[-0.0369181   0.00520969 -0.03232686 -0.01584067 -0.01450297 -1.76020896],-0.9275768734237663
650,RONY.JK,326,81,0.7037037037037037,103,223,[-0.01685109  0.02706879 -0.01856587  0.24142907 -0.00922599 -0.80437062],-0.7843800951411837
651,ROTI.JK,967,241,0.6431535269709544,290,677,[ 0.00019149  0.00542533  0.13657643  0.00842482 -0.00414676 -0.0070063 ],-0.8474972475500385
652,RSGK.JK,304,76,0.631578947368421,110,194,[-0.04566986 -0.01819918  0.08750137 -0.2900967   0.0239326  -0.75935951],-0.5533483808143976
653,RUIS.JK,968,241,0.6182572614107884,289,679,[-0.13381217 -0.05172571 -0.0479362  -0.06657573  0.01589802 -1.34589906],-0.8514351059219442
654,RUNS.JK,304,76,0.5657894736842105,110,194,[ 0.03623215 -0.12787486 -0.04464454 -0.21635052 -0.00419309 -0.6028079 ],-0.5632114504405744
655,SAFE.JK,968,241,0.7178423236514523,305,663,"[-5.06175683e-01 -1.84064067e-02  1.55968374e-02 -3.05272221e-02
  6.42799234e-04 -1.71018868e+00]",-0.770267369899617
656,SAME.JK,965,241,0.6224066390041494,339,626,[ 0.09156552 -0.02806755  0.03060703 -0.02169582  0.00290105 -0.44439928],-0.6160580181138063
657,SAMF.JK,581,145,0.503448275862069,196,385,[ 0.10905283  0.02264304  0.0090695  -0.02769916 -0.0286644   0.79917978],-0.6836635153999064
658,SAPX.JK,850,212,0.6698113207547169,207,643,[-0.31906879  0.00232546 -0.02107581 -0.10252497  0.00841436 -0.00270515],-1.1254254733236386
659,SATU.JK,789,197,0.817258883248731,223,566,"[-1.08475501e-01  3.70885152e-03  1.76315446e-02  9.46781220e-04
 -5.27803364e-02 -1.21500669e+00]",-0.9441151205170081
660,SBAT.JK,249,62,0.9838709677419355,79,170,[ 0.41556553 -0.04655446  0.69040464  0.19412989 -0.01092426  0.52749548],-0.7662469956279959
661,SBMA.JK,304,76,0.6052631578947368,107,197,"[ 1.82783827e-01  2.08123715e-02  2.01360242e-04  2.04248373e-02
 -3.50271533e-02  6.81125272e-01]",-0.6148226512777996
662,SCCO.JK,967,241,0.6887966804979253,238,729,"[-2.32727242e-02 -1.82256896e-04  1.44819854e-03 -1.18657796e-02
  1.39821618e-02 -1.42236784e+00]",-1.109422708153393
663,SCMA.JK,968,241,0.6390041493775933,390,578,[-0.03014446 -0.00592912 -0.02058766  0.09378888  0.00260334 -1.06323139],-0.3914384211571872
664,SCNP.JK,499,124,0.7016129032258065,157,342,[-0.08295893  0.07122367 -0.01409608 -0.15643922  0.02943934 -0.51575991],-0.7912709719341238
665,SDMU.JK,720,179,0.7039106145251397,145,575,[-0.0532892   0.05413274  0.22795275  0.04766918  0.01190951 -0.46825458],-1.381383185152307
666,SDPC.JK,967,241,0.6348547717842323,329,638,"[-2.48009778e-03  8.64983631e-07  4.25038633e-03 -2.49039050e-02
  3.43997311e-03 -2.94396692e-02]",-0.6705494431754171
667,SDRA.JK,966,241,0.6680497925311203,227,739,"[-2.75538688e-03 -1.51726401e-06 -5.51367573e-03  1.79986458e-02
 -5.60522025e-03 -8.91561024e-02]",-1.1929100987066832
668,SEMA.JK,236,58,0.7413793103448276,84,152,[ 0.01382731  0.13672649 -0.03216295  0.08924511  0.03686073 -0.25874155],-0.602014910680337
669,SFAN.JK,739,184,0.6304347826086957,249,490,[ 0.01946962  0.05104032  0.00079006 -0.10618299 -0.02892896  0.0205512 ],-0.6763451700051722
670,SGER.JK,512,128,0.65625,233,279,"[ 2.89792636e-01  3.82673243e-01  5.79690069e-02  8.04741635e-02
 -1.63669169e-04  1.65962745e-01]",-0.17663417645922122
671,SGRO.JK,967,241,0.6721991701244814,316,651,"[-3.14654032e-02  8.08505579e-02 -3.06332952e-02 -1.33900026e-03
  9.50457914e-03 -1.72716750e+00]",-0.7314463483993194
672,SHID.JK,960,240,0.6666666666666666,210,750,[ 0.19576317  0.00295084  0.0080159   0.03792414 -0.00445523  0.08674139],-1.2737628435136996
673,SHIP.JK,967,241,0.5352697095435685,353,614,"[-5.37813889e-02 -7.29125868e-05 -7.26968253e-03 -9.78845571e-03
  2.19375624e-02 -2.13119237e-01]",-0.549220187695946
674,SICO.JK,187,46,0.7391304347826086,66,121,[-0.00733377  0.0394381   0.03925591 -0.02281249  0.02209379 -0.37950126],-0.6005073966420293
675,SIDO.JK,968,241,0.6141078838174274,374,594,[-0.04965851 -0.00063323  0.01697882 -0.01171036 -0.03431015 -0.16220801],-0.4576856677293925
676,SILO.JK,968,241,0.5643153526970954,412,556,[ 0.07440454  0.01348986 -0.03275417 -0.0022911  -0.00896094  0.03734793],-0.2979168542991113
677,SIMA.JK,308,76,0.7763157894736842,102,206,[ 0.36701991  0.1425601   0.05918257  0.43962431  0.09563333 -0.05829748],-0.7169156566064543
678,SIMP.JK,967,241,0.6846473029045643,367,600,[ 0.0029935  -0.06524198  0.05500713  0.00510604 -0.0084294  -0.16011997],-0.50490260153022
679,SINI.JK,659,164,0.573170731707317,243,416,[-0.32390135 -0.01150885  0.00499347  0.00496976 -0.01635389 -1.84707402],-0.5384857576644545
680,SIPD.JK,968,241,0.7219917012448133,253,715,[-0.05753966 -0.01022362  0.01207275 -0.00088965 -0.00127564 -0.79929454],-1.0345633002696961
681,SKBM.JK,967,241,0.6058091286307054,259,708,"[-5.70420932e-01 -6.82586283e-04 -4.27474033e-03 -1.62318273e-02
  3.51218849e-03 -1.49468709e+00]",-1.0047259243537607
682,SKLT.JK,720,179,0.7932960893854749,186,534,"[-3.57433488e-01 -4.10546955e-05  2.33048933e-02 -6.34212721e-02
  2.12999064e-02 -1.61442799e+00]",-1.0528026183208952
683,SKRN.JK,884,220,0.5727272727272728,354,530,"[-3.67535698e-02  2.26267238e-02  5.49967838e-04  8.67182181e-02
  1.57321067e-03 -9.45165033e-01]",-0.40093168964252873
684,SKYB.JK,331,82,0.8048780487804879,88,243,[ 0.06983221 -0.04651755 -0.09576239 -0.1242466   0.02028935 -0.24890586],-1.0163100560674807
685,SLIS.JK,678,169,0.6804733727810651,274,404,[ 0.48577208  0.03487509 -0.01228004  0.05593455  0.03869765  1.47577085],-0.39597226157552584
686,SMAR.JK,932,232,0.5905172413793104,281,651,"[-9.13455405e-04  1.30581742e-06 -1.66922669e-02  1.42750021e-01
  4.22852202e-03 -3.02566170e-02]",-0.8313062585799895
687,SMBR.JK,967,241,0.6348547717842323,331,636,[ 0.20483561  0.02308384 -0.14019768 -0.07133481  0.00138596 -0.39944955],-0.6443234568600771
688,SMCB.JK,967,241,0.6887966804979253,318,649,[ 0.00339331 -0.0140328  -0.00429889 -0.00405197  0.00392706 -0.04716214],-0.7212017306743541
689,SMDM.JK,967,241,0.6348547717842323,335,632,[-0.32304206  0.01605177  0.00574033  0.02309534 -0.00890128 -2.97227574],-0.6388704723071265
690,SMDR.JK,968,241,0.6431535269709544,383,585,[ 0.01769421 -0.01832657  0.00302349  0.01060266 -0.00063519 -0.31296592],-0.42345204321325836
691,SMGR.JK,967,241,0.5726141078838174,424,543,[ 0.00325284  0.06622671 -0.01124754 -0.00229581 -0.00920246 -0.54220634],-0.24565445210226203
692,SMKL.JK,728,181,0.5580110497237569,270,458,[-0.10139763  0.03292878  0.01194926  0.10288987  0.01090457 -1.6343396 ],-0.5272893893069708
693,SMKM.JK,204,51,0.45098039215686275,101,103,[ 0.08238178  0.00090795  0.26542549  0.26497833 -0.0889673   0.20516625],-0.0038755657502759977
694,SMMA.JK,954,238,0.9201680672268907,150,804,[-0.07076666  0.01920359  0.04637878  0.00374415 -0.01686664 -0.76293265],-1.6793335608697681
695,SMMT.JK,967,241,0.6473029045643154,362,605,"[-2.52002098e-02  4.28059898e-03 -8.57188193e-03 -6.40185656e-02
 -1.29281822e-03 -1.44016786e+00]",-0.5049643062031476
696,SMRA.JK,967,241,0.6182572614107884,383,584,[ 0.00019486 -0.03590584  0.02064767  0.00237162  0.01187635 -0.00187308],-0.42553691709941843
697,SMRU.JK,256,63,0.8888888888888888,85,171,[ 0.02156919 -0.04333345  0.02606681  0.0764848  -0.02629992  0.44484533],-0.7269655378000887
698,SMSM.JK,968,241,0.5601659751037344,425,543,[-0.0303672  -0.00128193 -0.06971341  0.00827378 -0.00468464 -0.20063803],-0.23963503006288475
699,SNLK.JK,391,97,0.5360824742268041,183,208,[ 0.48952443  0.15518968  0.07566422 -0.16616393 -0.03703522  1.56400077],-0.12114419264674178
700,SOCI.JK,967,241,0.6016597510373444,355,612,"[-1.31693946e-01  8.57275113e-04 -3.94507271e-02 -5.93132616e-05
 -1.64872372e-03 -1.16288234e+00]",-0.539519260368172
701,SOFA.JK,530,132,0.8787878787878788,153,377,"[ 3.52929316e-01 -6.62262201e-02  1.42204366e-01  3.75133834e-01
  8.23779035e-05 -1.12548468e+00]",-0.8975089955359578
702,SOHO.JK,498,124,0.7983870967741935,166,332,"[-9.44905717e-02 -5.86829770e-02 -2.70902536e-02  1.42587063e-01
  8.67508214e-04 -1.32370588e+00]",-0.6894479913047131
703,SONA.JK,763,190,0.9736842105263158,68,695,[ 0.36871706 -0.03470509  0.01730196 -0.01070282 -0.00363585 -0.04486867],-2.3183200462743376
704,SOSS.JK,868,217,0.5345622119815668,340,528,"[-2.41759591e-01 -8.14076142e-03  1.36776028e-03 -4.11534168e-02
 -2.53136425e-03 -1.60301216e+00]",-0.43712333120605384
705,SOTS.JK,847,211,0.6919431279620853,277,570,"[-2.20681012e-01  2.43546283e-02  2.45053869e-02 -2.64828658e-02
  9.75772844e-04 -2.08547934e+00]",-0.7213538401623011
706,SOUL.JK,40,9,0.7777777777777778,9,31,[-0.00904213  0.37732536  0.05746274  0.0868267   0.46475036  0.4315765 ],-1.1922572518541668
707,SPMA.JK,968,241,0.6265560165975104,372,596,[-0.18148343  0.02576613 -0.02332781  0.11434073 -0.00567985 -1.41694864],-0.46896937409055217
708,SPTO.JK,967,241,0.7385892116182573,321,646,"[ 6.32164700e-04 -1.30194621e-02 -6.02178271e-02 -2.61830068e-02
 -5.18471145e-03 -9.31986940e-01]",-0.6882337191979507
709,SQMI.JK,967,241,0.6970954356846473,296,671,[ 0.00441283 -0.0417913  -0.00039125  0.08105598  0.00233295 -0.00971632],-0.8153018078214401
710,SRAJ.JK,968,241,0.6307053941908713,336,632,"[-5.45500795e-01 -3.38586217e-03 -1.43603039e-02 -4.29591446e-03
 -9.08504279e-04 -1.38830059e+00]",-0.6287766948062036
711,SRIL.JK,595,148,0.7094594594594594,213,382,[-0.13865853  0.02260898 -0.00659497  0.03281111 -0.00600814 -0.25666622],-0.5842494084929042
712,SRSN.JK,946,236,0.7966101694915254,272,674,"[-7.46297813e-02 -1.57384563e-03 -4.30209756e-02  2.29952757e-02
  3.96216361e-05 -1.95376224e+00]",-0.9054207710604242
713,SRTG.JK,968,241,0.6099585062240664,377,591,"[-3.81419329e-02  1.79904685e-03  6.09635943e-05 -9.12068028e-03
 -3.53866865e-03 -1.64574152e+00]",-0.4481082468372072
714,SSIA.JK,967,241,0.5809128630705395,353,614,[-0.00754549 -0.01013291  0.00637614  0.02863273 -0.00102196 -0.77902626],-0.5507884535928607
715,SSMS.JK,967,241,0.46473029045643155,367,600,"[-8.38605253e-13  7.71268383e-07  1.36174203e-09  3.12485792e-09
 -2.99770389e-09 -1.43857571e-10]",-2.744565029122224e-09
716,SSTM.JK,955,238,0.7815126050420168,259,696,[-0.34812848 -0.00054557 -0.06626797 -0.00177766 -0.00173392  0.08051552],-0.9999505630822326
717,STAA.JK,204,50,0.66,85,119,[ 0.02963994 -0.16999955  0.12098208 -0.72762232 -0.02866994 -0.92729794],-0.3484605542432202
718,STAR.JK,966,241,0.7302904564315352,294,672,[-0.01623679 -0.00917694 -0.02841297  0.00760412  0.00329432 -2.41723748],-0.8323296647715106
719,STTP.JK,750,187,0.732620320855615,159,591,[-0.00132241  0.00965696  0.0443713  -0.0101463   0.01630824  0.00504877],-1.3155901544518591
720,SULI.JK,594,148,0.6216216216216216,154,440,[ 0.27222164  0.05486362 -0.01786187 -0.21290929  0.00944753  0.10014748],-1.0617302288346377
721,SUNI.JK,39,9,0.7777777777777778,17,22,[-0.00600237  0.22448572  0.31883221  0.47656706 -0.24544335  0.37709417],-0.4139897886210142
722,SUPR.JK,630,157,0.9681528662420382,80,550,[ 0.60305813  0.06388513 -0.0187508  -0.00168205 -0.00356383  0.0219573 ],-1.9433592830294004
723,SURE.JK,862,215,0.9348837209302325,165,697,[-0.16789612 -0.01080328 -0.02929453 -0.00135536 -0.00213633 -1.09269757],-1.435043167582491
724,SWAT.JK,911,227,0.748898678414097,302,609,[-0.33244375 -0.01976757  0.04500882  0.01515955  0.01084795 -0.74336342],-0.7051082683171402
725,SWID.JK,144,35,0.6857142857142857,38,106,[-0.02875665 -0.31784951  0.15052687  0.23134899  0.09146688 -0.8627917 ],-1.0144074813003798
726,TALF.JK,964,241,0.7053941908713693,252,712,"[-5.34117849e-01  4.28342586e-04  3.46181667e-02 -9.74596078e-02
 -3.55570484e-03 -1.41084100e+00]",-1.0394945663936794
727,TAMA.JK,472,117,0.8888888888888888,151,321,[-0.08073324 -0.06538715  0.05667365 -0.02342955  0.01241246 -0.07544055],-0.7661353641868488
728,TAMU.JK,496,124,0.7903225806451613,232,264,[0.14851799 0.26120147 0.01736134 0.0073224  0.01424017 0.09507435],-0.12641957337300727
729,TAPG.JK,384,95,0.6736842105263158,157,227,[-0.11379654 -0.17341273 -0.13427148 -0.00399402 -0.00649165 -0.25503996],-0.4122639162566046
730,TARA.JK,397,99,0.9696969696969697,156,241,[ 0.12299905  0.05013863  0.00324507 -0.00964109 -0.04452253 -1.61428318],-0.4374644220802564
731,TAYS.JK,255,63,0.7777777777777778,93,162,[ 0.01553686 -0.06124873  0.02368854  0.20849506 -0.01456664  0.32896897],-0.5736140403374613
732,TBIG.JK,968,241,0.5809128630705395,425,543,[-0.00913591  0.0041068  -0.00673846  0.15661408  0.01257163 -0.7440985 ],-0.2484917103698929
733,TBLA.JK,967,241,0.7136929460580913,387,580,[-0.0123415  -0.00406642  0.01557832  0.14167744  0.00561569 -0.02513279],-0.4048716069614391
734,TBMS.JK,967,241,0.7136929460580913,252,715,"[-1.86999288e-03  2.63627252e-06  1.07740097e-03 -2.19151409e-02
  8.39841481e-03 -4.87895683e-02]",-1.0523651522600155
735,TCID.JK,948,236,0.6186440677966102,192,756,[-0.10614708  0.00141023 -0.01441433  0.05584683 -0.00475648 -0.59780544],-1.3682911892586935
736,TCPI.JK,892,222,0.536036036036036,423,469,[-0.05433774 -0.01734289  0.09200686  0.03903786  0.02920038 -0.0463346 ],-0.10977060322636548
737,TDPM.JK,585,146,0.6643835616438356,197,388,[-0.12063025  0.01842899  0.01269499  0.04245929  0.01686383 -0.10882586],-0.6672900381028475
738,TEBE.JK,642,160,0.59375,187,455,[-0.10544385  0.00989802  0.02620669  0.04359082 -0.02354482 -0.32993753],-0.8849602179363786
739,TECH.JK,498,124,0.7661290322580645,218,280,"[ 4.32342973e-02 -2.85741009e-02 -2.06461662e-02  1.20108383e-03
 -4.41944399e-02  1.34448033e+00]",-0.26738802328930605
740,TELE.JK,423,105,0.7333333333333333,121,302,[-0.14661551  0.0230448   0.02104554 -0.28230332 -0.00104311 -0.59298461],-0.9034906849795484
741,TFAS.JK,671,167,0.6107784431137725,250,421,[ 0.36486775 -0.00912369  0.10801982 -0.00488524  0.05465818  0.33249465],-0.5183283621939268
742,TFCO.JK,956,238,0.9033613445378151,229,727,[-0.01471406  0.00643764  0.00783843 -0.00333944 -0.00065717 -0.2381735 ],-1.1530251399370073
743,TGKA.JK,960,239,0.702928870292887,213,747,[-0.18233822 -0.02187275  0.07511715  0.00606363 -0.02413567 -0.60384748],-1.2780396479174634
744,TGRA.JK,917,229,0.7947598253275109,294,623,[ 0.08334184  0.00312072 -0.00346071 -0.01035502 -0.00263036 -0.27687773],-0.7460918773296079
745,TIFA.JK,967,241,0.7302904564315352,323,644,"[-5.36856428e-04  2.53651152e-03  1.55003796e-03  3.06369623e-03
 -3.64203465e-02 -5.96545500e-01]",-0.6887775001306164
746,TINS.JK,966,241,0.6099585062240664,392,574,[-0.06978499  0.01542186 -0.0965325  -0.044817    0.00989166 -0.57086797],-0.3823892666273126
747,TIRA.JK,966,241,0.6431535269709544,302,664,[-0.44866796  0.00804869 -0.00337384  0.02465772 -0.03143463 -1.707244  ],-0.7900989154928163
748,TIRT.JK,897,224,0.7767857142857143,241,656,[-0.17549011  0.01291606  0.03245458 -0.05412218 -0.00456459 -3.09798142],-1.0207333648907901
749,TKIM.JK,967,241,0.6099585062240664,398,569,[-0.12675002 -0.00438159  0.03229963 -0.01727247  0.04876298  0.40111284],-0.3588933270037241
750,TLDN.JK,185,46,0.6521739130434783,39,146,[-0.01501069  0.00373037 -0.15170474 -0.28552231  0.00630212 -0.8855623 ],-1.3144568446526794
751,TLKM.JK,967,241,0.5601659751037344,417,550,[-0.03241404  0.01586005  0.01600537 -0.03009787 -0.00149316 -0.56352001],-0.278935647935132
752,TMAS.JK,968,241,0.5352697095435685,317,651,"[ 1.93754494e-01  4.70356184e-02 -9.78455131e-03 -6.33971003e-04
 -1.02536860e-02 -7.20276328e-01]",-0.7128903362559541
753,TMPO.JK,965,241,0.6721991701244814,295,670,[-0.37317238  0.10012524  0.01153933  0.00482621 -0.00428567 -2.21190415],-0.8218395291734002
754,TNCA.JK,942,235,0.6638297872340425,341,601,"[-2.47257284e-02  4.31561263e-03 -1.25993577e-04  1.07059007e-01
  3.91884062e-04 -7.48001261e-01]",-0.5631633904251039
755,TOBA.JK,967,241,0.6556016597510373,257,710,[-0.00159825  0.00586488  0.00702503  0.11480852 -0.00084158 -0.78731872],-1.0118645039571121
756,TOOL.JK,124,31,0.6774193548387096,25,99,"[-2.84431656e-02  6.11697878e-02 -1.22977226e-01  4.90589629e-01
  1.40178857e-03  1.64509960e+00]",-1.390663668048305
757,TOPS.JK,408,102,0.9313725490196079,131,277,[-0.03633737 -0.02509975 -0.11555466  0.14344459  0.02115216 -0.161235  ],-0.7534514861272859
758,TOTL.JK,967,241,0.6265560165975104,310,657,"[ 8.91275629e-05  7.41165507e-05  5.22082352e-04 -3.51407589e-02
 -1.07347429e-01 -6.38807991e-03]",-0.3541590959751836
759,TOTO.JK,967,241,0.6887966804979253,303,664,[-0.02364742  0.01421843 -0.00823187  0.02073922  0.02269632 -2.52017968],-0.790599254456733
760,TOWR.JK,967,241,0.5933609958506224,368,599,[-0.02391241  0.00426737 -0.01073962 -0.01054163  0.0168412  -1.11092305],-0.4817707914541279
761,TOYS.JK,513,128,0.7265625,164,349,[ 0.14354078  0.15898609 -0.12615674  0.43730271 -0.04698185 -0.52465084],-0.7764923837128601
762,TPIA.JK,968,241,0.5975103734439834,463,505,[ 0.47075356  0.04165534 -0.0311915  -0.30409649 -0.0142059   0.58207633],-0.10966019375903602
763,TPMA.JK,967,241,0.5767634854771784,280,687,"[ 2.84913687e-03 -2.03073324e-05 -8.03801505e-02  2.68622681e-02
 -1.04284901e-03 -2.53178811e-01]",-0.8921006321209534
764,TRAM.JK,324,81,0.8024691358024691,108,216,[-0.1013623   0.00665455 -0.0211444   0.12025966  0.06126684 -0.8919727 ],-0.6982058061342
765,TRGU.JK,143,35,0.7428571428571429,38,105,[-0.03023197 -0.01446744 -0.03926755  0.594514    0.0108928  -0.88653476],-0.9903229236135506
766,TRIM.JK,964,241,0.6224066390041494,305,659,[-0.10676164 -0.01060269 -0.00773611 -0.10225914  0.03195463 -2.99042568],-0.7905315342958353
767,TRIN.JK,623,155,0.632258064516129,237,386,[ 0.0445155   0.12695273  0.06012375  0.10257733 -0.01181359 -0.02743472],-0.49380704597680225
768,TRIS.JK,968,241,0.6224066390041494,300,668,[-0.3814864   0.01584248 -0.03149739  0.02205711  0.0085008  -0.92501477],-0.7952657871665699
769,TRJA.JK,504,126,0.5952380952380952,211,293,[-0.02973746  0.01094549  0.07360086 -0.11463563  0.01190487  0.29597557],-0.3403573058847675
770,TRON.JK,6,1,0.0,2,4,[ 0.00224168 -0.03318766 -0.00792738  0.57100263 -0.21831872  0.12533687],-0.8911220378350136
771,TRST.JK,929,232,0.7370689655172413,159,770,"[-1.54956500e-02 -7.86179642e-02  1.11082833e-01  9.30183998e-03
  2.08283299e-04 -2.06499408e+00]",-1.6114938334113211
772,TRUE.JK,303,75,0.9066666666666666,81,222,[ 0.00787236  0.07075689  0.12771331 -0.46988398  0.09059643 -0.02101605],-1.0278812482166344
773,TRUK.JK,962,240,0.65,327,635,[-0.04077702 -0.03619825 -0.01119242 -0.04026183  0.01061203 -0.2459611 ],-0.6597307333207842
774,TRUS.JK,968,241,0.6141078838174274,274,694,[-0.49889826 -0.00514577 -0.00104057  0.02275695 -0.00283051 -0.62733172],-0.9231338601719862
775,TSPC.JK,968,241,0.6639004149377593,344,624,[ 0.00761399 -0.00961583  0.00900833 -0.02137661 -0.00321806 -0.26566015],-0.593137598277626
776,TUGU.JK,961,240,0.5875,293,668,[-0.17550665  0.00035963  0.04432187  0.03181901  0.00697685  0.09940788],-0.8255503463406478
777,UANG.JK,532,132,0.6287878787878788,168,364,[-0.06464742  0.04026531 -0.02360706  0.00125534 -0.09303671 -0.76362093],-0.7789251130995237
778,UCID.JK,635,158,0.6708860759493671,225,410,[-0.00951226 -0.00240519  0.00164925 -0.08558547 -0.00947878 -0.19169464],-0.5998749811727939
779,UFOE.JK,421,105,0.5904761904761905,174,247,[ 0.18654411  0.09880153 -0.03308067 -0.02482562  0.00777791  1.96966943],-0.37015210072706
780,ULTJ.JK,967,241,0.6099585062240664,350,617,"[-2.26088597e-02 -9.91764695e-05  1.12509609e-02  1.11670419e-01
 -7.76787525e-03 -7.41690535e-01]",-0.5612369132994548
781,UNIC.JK,966,241,0.6639004149377593,313,653,[-0.0027919  -0.00754247  0.01239811 -0.04670276  0.00171033 -0.8291771 ],-0.7346480075220181
782,UNIQ.JK,402,100,0.68,102,300,[-0.107399    0.06213848 -0.02582608  0.25322265  0.00356901 -2.67165284],-1.0968568883096839
783,UNIT.JK,555,138,0.6594202898550725,166,389,[-0.27124209 -0.01536788 -0.00487991  0.12278213  0.00744456 -1.41032586],-0.8684948262086757
784,UNSP.JK,967,241,0.5892116182572614,369,598,[-0.01397336 -0.0364227   0.00370275 -0.0170379  -0.01317054 -0.87719106],-0.4819759463989747
785,UNTR.JK,967,241,0.5560165975103735,431,536,[-0.02041012  0.06475289 -0.01135811  0.01117117 -0.01024429 -0.93023223],-0.2115830222381632
786,UNVR.JK,968,241,0.5394190871369294,395,573,[-0.01064219  0.00526793  0.02055356 -0.01838701 -0.00551018 -0.52501552],-0.371308012361312
787,URBN.JK,848,212,0.5990566037735849,187,661,[ 0.05464592 -0.04168557  0.00079287 -0.03818907  0.00438376 -0.00930572],-1.2691474167544803
788,UVCR.JK,328,81,0.6419753086419753,123,205,[-0.08340218  0.1954199  -0.04330871 -0.39783263  0.09523796  0.82453216],-0.5301039554946839
789,VAST.JK,22,5,0.6,5,17,[-0.00584213  0.10669157 -0.23391538 -0.27856208 -0.07405376 -0.22645761],-1.3438853445700396
790,VICI.JK,444,110,0.5909090909090909,160,284,[ 0.08864347 -0.03224046  0.03693745 -0.15348358  0.0225163   0.40737619],-0.5611739659892067
791,VICO.JK,966,241,0.6680497925311203,330,636,"[-2.53887387e-01 -3.70554966e-02 -4.17737497e-02 -2.76510842e-02
 -2.34355814e-03 -3.15688693e+00]",-0.6608059388427043
792,VINS.JK,967,241,0.6307053941908713,357,610,[-0.44003136 -0.01277052 -0.00426171  0.01508775 -0.00250692 -1.78350869],-0.5209712668856796
793,VIVA.JK,540,134,0.8432835820895522,147,393,[ 0.00600719 -0.02464169  0.04833091 -0.06753915 -0.00811719  0.75892778],-0.9796242846885618
794,VOKS.JK,967,241,0.5560165975103735,363,604,[-0.20868755  0.0347969   0.03878641  0.05186356  0.00236146 -0.91269075],-0.5104958079232559
795,VRNA.JK,957,239,0.6401673640167364,249,708,[-0.43477671  0.07897006  0.03347744  0.03013566 -0.00176889 -0.16454375],-1.0510662681305076
796,VTNY.JK,52,13,0.5384615384615384,22,30,[-0.03913322  0.73790924 -0.40896292  0.29323234 -0.05206566 -0.12993118],-0.4239754424753311
797,WAPO.JK,966,241,0.6307053941908713,296,670,[-0.03780985 -0.02315457 -0.00955643 -0.00794601 -0.00289487 -2.06370697],-0.8202178459210915
798,WEGE.JK,967,241,0.6597510373443983,374,593,[-0.01761752  0.02509913 -0.01403086 -0.0071915  -0.00612425 -1.15637654],-0.4529650692198216
799,WEHA.JK,967,241,0.6473029045643154,298,669,[ 0.0586462  -0.00406064  0.06125035  0.03032646  0.0017837   0.57271241],-0.8224085799333385
800,WGSH.JK,255,63,0.6190476190476191,95,160,[-0.00563204  0.23573459  0.06415457  0.11061683 -0.00278854 -0.18728022],-0.5252610207469911
801,WICO.JK,965,241,0.7842323651452282,182,783,[-0.42718064  0.01326273  0.01843432 -0.00443628  0.02809301 -2.34066278],-1.4809568359353098
802,WIFI.JK,438,109,0.6146788990825688,153,285,[ 0.0137854   0.00648849 -0.06503213  0.04261603 -0.00346289  0.38397679],-0.6253107560792777
803,WIIM.JK,967,241,0.5643153526970954,329,638,[ 0.00726923 -0.07782372 -0.01076962 -0.00243889 -0.0006262   0.19181836],-0.6657142510629426
804,WIKA.JK,966,241,0.6473029045643154,398,568,[ 0.00794183  0.01934174  0.02358332 -0.00855919 -0.00220846 -0.31557536],-0.35108914765880544
805,WINE.JK,38,9,0.7777777777777778,15,23,[-0.01641724 -0.08871046  0.03571235  0.38307026  0.32467582  0.0566841 ],-0.45154078053657776
806,WINR.JK,67,16,1.0,7,60,[-0.02382262  0.00048015 -0.01230405  0.06778912  0.15779388  0.46596418],-2.149651234882836
807,WINS.JK,965,241,0.5518672199170125,310,655,"[-2.13283909e-01 -1.09555224e-03 -7.41587823e-03  2.90684251e-01
  1.47581549e-02 -2.12652287e+00]",-0.7549328823315786
808,WIRG.JK,190,47,0.6170212765957447,58,132,[ 0.03669596 -0.03090636  0.09887292  0.1311372   0.00245574 -0.56674036],-0.8204946840728847
809,WMPP.JK,255,63,0.8412698412698413,98,157,[ 0.04346614  0.00547781  0.00758899  0.0746653   0.01167991 -0.92150149],-0.46941257678366843
810,WMUU.JK,420,105,0.7904761904761904,141,279,[-0.07162793 -0.04876393 -0.10247493  0.02611336  0.08135121 -0.80807928],-0.6899875879320776
811,WOMF.JK,967,241,0.6182572614107884,343,624,"[-1.51318718e-01  1.02442566e-04  1.37490622e-03  1.71097159e-02
 -1.50664894e-02 -1.24288170e+00]",-0.5921421011989004
812,WOOD.JK,967,241,0.6390041493775933,352,615,[-0.01403517  0.05055717 -0.00633781  0.01217963  0.0163592  -0.26954326],-0.5573903976870881
813,WOWS.JK,424,105,0.8761904761904762,98,326,[ 0.02421592 -0.07190298  0.02799242 -0.00226313 -0.02088034 -1.29962198],-1.2160112999643053
814,WSBP.JK,762,190,0.7315789473684211,279,483,[-0.01171334  0.00480581 -0.0072328   0.04955993 -0.00648699 -0.31132825],-0.5502425504832321
815,WSKT.JK,966,241,0.6970954356846473,376,590,[ 0.11443225  0.04245459 -0.00242768  0.00326778  0.00476978  0.01882391],-0.45613224570848754
816,WTON.JK,967,241,0.6431535269709544,366,601,[-0.12653366 -0.00812658 -0.01914898 -0.01390369 -0.03324169 -0.1219569 ],-0.5042655205117815
817,YELO.JK,777,194,0.7216494845360825,226,551,[ 0.10885628 -0.08559416 -0.1076607   0.09154985  0.01064065 -0.89976339],-0.8933921234970476
818,YPAS.JK,965,241,0.6390041493775933,251,714,[-0.35473499 -0.00250607 -0.01532446  0.05208364 -0.00368458  0.43458951],-1.0601050774213083
819,YULE.JK,958,239,0.7782426778242678,246,712,[-0.03926886  0.04280922  0.00324382  0.02006136 -0.00636625 -1.29430591],-1.0613658070127898
820,ZATA.JK,72,18,0.8333333333333334,16,56,[ 0.01870691 -0.14638128  0.81331936 -0.0724902   0.17878615  0.78265354],-1.1870632697000543
821,ZBRA.JK,608,152,0.8026315789473685,157,451,[ 0.79339378  0.04012275 -0.01887694  0.13866779  0.04084999 -0.47687178],-1.0639587668572374
822,ZINC.JK,888,221,0.7375565610859729,335,553,[ 0.17402917 -0.01695566  0.05726537 -0.03034594 -0.00287274  0.04504757],-0.5024322711312372
823,ZONE.JK,847,211,0.5924170616113744,313,534,"[2.24719585e-01 4.55269754e-05 9.70891543e-02 3.23603163e-02
 3.49360312e-02 3.69210761e-01]",-0.5496363774758997
824,ZYRX.JK,390,97,0.7422680412371134,139,251,[ 0.04488271 -0.03268651  0.01129248  0.19334168 -0.0259352   0.56729314],-0.5992477174019624
